simulation, visitors, current conversion rate, overall conversion rate, total conversions, pulls arm 1, pulls arm 2
0, 50, 0.48, 0.48, 24, 24, 26
0, 100, 0.28, 0.38, 38, 47, 53
0, 150, 0.44, 0.4, 60, 65, 85
0, 200, 0.4, 0.4, 80, 85, 115
0, 250, 0.36, 0.392, 98, 111, 139
0, 300, 0.38, 0.39, 117, 134, 166
0, 350, 0.48, 0.402857142857, 141, 158, 192
0, 400, 0.4, 0.4025, 161, 186, 214
0, 450, 0.34, 0.395555555556, 178, 208, 242
0, 500, 0.44, 0.4, 200, 231, 269
0, 550, 0.46, 0.405454545455, 223, 253, 297
0, 600, 0.5, 0.413333333333, 248, 275, 325
0, 650, 0.56, 0.424615384615, 276, 299, 351
0, 700, 0.54, 0.432857142857, 303, 327, 373
0, 750, 0.52, 0.438666666667, 329, 353, 397
0, 800, 0.52, 0.44375, 355, 371, 429
0, 850, 0.42, 0.442352941176, 376, 397, 453
0, 900, 0.48, 0.444444444444, 400, 421, 479
0, 950, 0.56, 0.450526315789, 428, 448, 502
0, 1000, 0.44, 0.45, 450, 477, 523
0, 1050, 0.4, 0.447619047619, 470, 498, 552
0, 1100, 0.66, 0.457272727273, 503, 527, 573
0, 1150, 0.5, 0.459130434783, 528, 541, 609
0, 1200, 0.5, 0.460833333333, 553, 565, 635
0, 1250, 0.6, 0.4664, 583, 590, 660
0, 1300, 0.58, 0.470769230769, 612, 615, 685
0, 1350, 0.46, 0.47037037037, 635, 641, 709
0, 1400, 0.54, 0.472857142857, 662, 667, 733
0, 1450, 0.46, 0.472413793103, 685, 689, 761
0, 1500, 0.46, 0.472, 708, 717, 783
0, 1550, 0.42, 0.470322580645, 729, 733, 817
0, 1600, 0.48, 0.470625, 753, 757, 843
0, 1650, 0.52, 0.472121212121, 779, 783, 867
0, 1700, 0.56, 0.474705882353, 807, 811, 889
0, 1750, 0.48, 0.474857142857, 831, 831, 919
0, 1800, 0.38, 0.472222222222, 850, 859, 941
0, 1850, 0.5, 0.472972972973, 875, 886, 964
0, 1900, 0.5, 0.473684210526, 900, 913, 987
0, 1950, 0.44, 0.472820512821, 922, 937, 1013
0, 2000, 0.5, 0.4735, 947, 962, 1038
1, 50, 0.44, 0.44, 22, 23, 27
1, 100, 0.36, 0.4, 40, 49, 51
1, 150, 0.42, 0.406666666667, 61, 70, 80
1, 200, 0.5, 0.43, 86, 95, 105
1, 250, 0.24, 0.392, 98, 123, 127
1, 300, 0.46, 0.403333333333, 121, 150, 150
1, 350, 0.46, 0.411428571429, 144, 174, 176
1, 400, 0.42, 0.4125, 165, 201, 199
1, 450, 0.64, 0.437777777778, 197, 226, 224
1, 500, 0.36, 0.43, 215, 247, 253
1, 550, 0.48, 0.434545454545, 239, 269, 281
1, 600, 0.42, 0.433333333333, 260, 298, 302
1, 650, 0.5, 0.438461538462, 285, 323, 327
1, 700, 0.5, 0.442857142857, 310, 351, 349
1, 750, 0.42, 0.441333333333, 331, 374, 376
1, 800, 0.52, 0.44625, 357, 395, 405
1, 850, 0.48, 0.448235294118, 381, 419, 431
1, 900, 0.48, 0.45, 405, 442, 458
1, 950, 0.68, 0.462105263158, 439, 467, 483
1, 1000, 0.54, 0.466, 466, 484, 516
1, 1050, 0.44, 0.464761904762, 488, 506, 544
1, 1100, 0.38, 0.460909090909, 507, 535, 565
1, 1150, 0.5, 0.462608695652, 532, 559, 591
1, 1200, 0.48, 0.463333333333, 556, 577, 623
1, 1250, 0.6, 0.4688, 586, 602, 648
1, 1300, 0.48, 0.469230769231, 610, 631, 669
1, 1350, 0.44, 0.468148148148, 632, 658, 692
1, 1400, 0.46, 0.467857142857, 655, 680, 720
1, 1450, 0.42, 0.466206896552, 676, 704, 746
1, 1500, 0.42, 0.464666666667, 697, 727, 773
1, 1550, 0.58, 0.468387096774, 726, 753, 797
1, 1600, 0.46, 0.468125, 749, 779, 821
1, 1650, 0.36, 0.464848484848, 767, 801, 849
1, 1700, 0.48, 0.465294117647, 791, 822, 878
1, 1750, 0.52, 0.466857142857, 817, 845, 905
1, 1800, 0.6, 0.470555555556, 847, 868, 932
1, 1850, 0.56, 0.472972972973, 875, 899, 951
1, 1900, 0.4, 0.471052631579, 895, 922, 978
1, 1950, 0.66, 0.475897435897, 928, 950, 1000
1, 2000, 0.48, 0.476, 952, 970, 1030
2, 50, 0.5, 0.5, 25, 21, 29
2, 100, 0.4, 0.45, 45, 48, 52
2, 150, 0.4, 0.433333333333, 65, 70, 80
2, 200, 0.38, 0.42, 84, 90, 110
2, 250, 0.26, 0.388, 97, 124, 126
2, 300, 0.34, 0.38, 114, 150, 150
2, 350, 0.42, 0.385714285714, 135, 173, 177
2, 400, 0.34, 0.38, 152, 200, 200
2, 450, 0.56, 0.4, 180, 218, 232
2, 500, 0.48, 0.408, 204, 244, 256
2, 550, 0.44, 0.410909090909, 226, 266, 284
2, 600, 0.68, 0.433333333333, 260, 285, 315
2, 650, 0.48, 0.436923076923, 284, 310, 340
2, 700, 0.46, 0.438571428571, 307, 329, 371
2, 750, 0.44, 0.438666666667, 329, 354, 396
2, 800, 0.44, 0.43875, 351, 382, 418
2, 850, 0.4, 0.436470588235, 371, 409, 441
2, 900, 0.5, 0.44, 396, 434, 466
2, 950, 0.46, 0.441052631579, 419, 464, 486
2, 1000, 0.44, 0.441, 441, 489, 511
2, 1050, 0.52, 0.444761904762, 467, 517, 533
2, 1100, 0.54, 0.449090909091, 494, 543, 557
2, 1150, 0.54, 0.453043478261, 521, 571, 579
2, 1200, 0.54, 0.456666666667, 548, 595, 605
2, 1250, 0.48, 0.4576, 572, 617, 633
2, 1300, 0.68, 0.466153846154, 606, 648, 652
2, 1350, 0.44, 0.465185185185, 628, 670, 680
2, 1400, 0.5, 0.466428571429, 653, 695, 705
2, 1450, 0.34, 0.462068965517, 670, 713, 737
2, 1500, 0.46, 0.462, 693, 740, 760
2, 1550, 0.46, 0.461935483871, 716, 761, 789
2, 1600, 0.52, 0.46375, 742, 786, 814
2, 1650, 0.48, 0.464242424242, 766, 813, 837
2, 1700, 0.6, 0.468235294118, 796, 837, 863
2, 1750, 0.48, 0.468571428571, 820, 859, 891
2, 1800, 0.56, 0.471111111111, 848, 885, 915
2, 1850, 0.56, 0.473513513514, 876, 909, 941
2, 1900, 0.36, 0.470526315789, 894, 933, 967
2, 1950, 0.5, 0.471282051282, 919, 961, 989
2, 2000, 0.4, 0.4695, 939, 984, 1016
3, 50, 0.38, 0.38, 19, 22, 28
3, 100, 0.3, 0.34, 34, 43, 57
3, 150, 0.34, 0.34, 51, 69, 81
3, 200, 0.34, 0.34, 68, 87, 113
3, 250, 0.44, 0.36, 90, 117, 133
3, 300, 0.34, 0.356666666667, 107, 140, 160
3, 350, 0.46, 0.371428571429, 130, 163, 187
3, 400, 0.36, 0.37, 148, 195, 205
3, 450, 0.42, 0.375555555556, 169, 224, 226
3, 500, 0.44, 0.382, 191, 252, 248
3, 550, 0.46, 0.389090909091, 214, 277, 273
3, 600, 0.62, 0.408333333333, 245, 304, 296
3, 650, 0.4, 0.407692307692, 265, 323, 327
3, 700, 0.54, 0.417142857143, 292, 352, 348
3, 750, 0.48, 0.421333333333, 316, 374, 376
3, 800, 0.58, 0.43125, 345, 407, 393
3, 850, 0.44, 0.431764705882, 367, 432, 418
3, 900, 0.46, 0.433333333333, 390, 462, 438
3, 950, 0.5, 0.436842105263, 415, 484, 466
3, 1000, 0.56, 0.443, 443, 509, 491
3, 1050, 0.36, 0.439047619048, 461, 533, 517
3, 1100, 0.5, 0.441818181818, 486, 556, 544
3, 1150, 0.54, 0.446086956522, 513, 583, 567
3, 1200, 0.4, 0.444166666667, 533, 608, 592
3, 1250, 0.64, 0.452, 565, 634, 616
3, 1300, 0.5, 0.453846153846, 590, 655, 645
3, 1350, 0.4, 0.451851851852, 610, 682, 668
3, 1400, 0.52, 0.454285714286, 636, 703, 697
3, 1450, 0.54, 0.45724137931, 663, 723, 727
3, 1500, 0.48, 0.458, 687, 745, 755
3, 1550, 0.52, 0.46, 713, 770, 780
3, 1600, 0.5, 0.46125, 738, 791, 809
3, 1650, 0.56, 0.464242424242, 766, 817, 833
3, 1700, 0.56, 0.467058823529, 794, 841, 859
3, 1750, 0.42, 0.465714285714, 815, 862, 888
3, 1800, 0.58, 0.468888888889, 844, 882, 918
3, 1850, 0.48, 0.469189189189, 868, 909, 941
3, 1900, 0.5, 0.47, 893, 935, 965
3, 1950, 0.4, 0.468205128205, 913, 967, 983
3, 2000, 0.34, 0.465, 930, 992, 1008
4, 50, 0.34, 0.34, 17, 27, 23
4, 100, 0.48, 0.41, 41, 49, 51
4, 150, 0.44, 0.42, 63, 76, 74
4, 200, 0.42, 0.42, 84, 99, 101
4, 250, 0.28, 0.392, 98, 127, 123
4, 300, 0.3, 0.376666666667, 113, 146, 154
4, 350, 0.4, 0.38, 133, 170, 180
4, 400, 0.42, 0.385, 154, 196, 204
4, 450, 0.44, 0.391111111111, 176, 218, 232
4, 500, 0.56, 0.408, 204, 240, 260
4, 550, 0.56, 0.421818181818, 232, 265, 285
4, 600, 0.38, 0.418333333333, 251, 287, 313
4, 650, 0.46, 0.421538461538, 274, 309, 341
4, 700, 0.46, 0.424285714286, 297, 334, 366
4, 750, 0.54, 0.432, 324, 358, 392
4, 800, 0.5, 0.43625, 349, 381, 419
4, 850, 0.5, 0.44, 374, 402, 448
4, 900, 0.6, 0.448888888889, 404, 435, 465
4, 950, 0.6, 0.456842105263, 434, 465, 485
4, 1000, 0.42, 0.455, 455, 489, 511
4, 1050, 0.52, 0.458095238095, 481, 516, 534
4, 1100, 0.6, 0.464545454545, 511, 545, 555
4, 1150, 0.38, 0.460869565217, 530, 572, 578
4, 1200, 0.48, 0.461666666667, 554, 593, 607
4, 1250, 0.48, 0.4624, 578, 623, 627
4, 1300, 0.46, 0.462307692308, 601, 647, 653
4, 1350, 0.48, 0.462962962963, 625, 674, 676
4, 1400, 0.36, 0.459285714286, 643, 698, 702
4, 1450, 0.46, 0.459310344828, 666, 724, 726
4, 1500, 0.5, 0.460666666667, 691, 747, 753
4, 1550, 0.58, 0.464516129032, 720, 771, 779
4, 1600, 0.5, 0.465625, 745, 793, 807
4, 1650, 0.48, 0.466060606061, 769, 819, 831
4, 1700, 0.52, 0.467647058824, 795, 849, 851
4, 1750, 0.52, 0.469142857143, 821, 871, 879
4, 1800, 0.54, 0.471111111111, 848, 899, 901
4, 1850, 0.56, 0.473513513514, 876, 921, 929
4, 1900, 0.56, 0.475789473684, 904, 944, 956
4, 1950, 0.58, 0.478461538462, 933, 970, 980
4, 2000, 0.46, 0.478, 956, 998, 1002
5, 50, 0.52, 0.52, 26, 18, 32
5, 100, 0.4, 0.46, 46, 37, 63
5, 150, 0.44, 0.453333333333, 68, 66, 84
5, 200, 0.36, 0.43, 86, 92, 108
5, 250, 0.4, 0.424, 106, 114, 136
5, 300, 0.44, 0.426666666667, 128, 132, 168
5, 350, 0.36, 0.417142857143, 146, 152, 198
5, 400, 0.48, 0.425, 170, 179, 221
5, 450, 0.42, 0.424444444444, 191, 207, 243
5, 500, 0.48, 0.43, 215, 234, 266
5, 550, 0.5, 0.436363636364, 240, 255, 295
5, 600, 0.52, 0.443333333333, 266, 284, 316
5, 650, 0.44, 0.443076923077, 288, 306, 344
5, 700, 0.58, 0.452857142857, 317, 329, 371
5, 750, 0.48, 0.454666666667, 341, 346, 404
5, 800, 0.44, 0.45375, 363, 368, 432
5, 850, 0.38, 0.449411764706, 382, 391, 459
5, 900, 0.5, 0.452222222222, 407, 419, 481
5, 950, 0.58, 0.458947368421, 436, 445, 505
5, 1000, 0.46, 0.459, 459, 470, 530
5, 1050, 0.46, 0.459047619048, 482, 495, 555
5, 1100, 0.58, 0.464545454545, 511, 521, 579
5, 1150, 0.54, 0.467826086957, 538, 542, 608
5, 1200, 0.58, 0.4725, 567, 567, 633
5, 1250, 0.58, 0.4768, 596, 596, 654
5, 1300, 0.58, 0.480769230769, 625, 629, 671
5, 1350, 0.56, 0.483703703704, 653, 658, 692
5, 1400, 0.54, 0.485714285714, 680, 687, 713
5, 1450, 0.54, 0.487586206897, 707, 716, 734
5, 1500, 0.56, 0.49, 735, 739, 761
5, 1550, 0.42, 0.487741935484, 756, 768, 782
5, 1600, 0.48, 0.4875, 780, 792, 808
5, 1650, 0.6, 0.490909090909, 810, 822, 828
5, 1700, 0.56, 0.492941176471, 838, 852, 848
5, 1750, 0.38, 0.489714285714, 857, 875, 875
5, 1800, 0.54, 0.491111111111, 884, 899, 901
5, 1850, 0.54, 0.492432432432, 911, 927, 923
5, 1900, 0.38, 0.489473684211, 930, 947, 953
5, 1950, 0.48, 0.489230769231, 954, 969, 981
5, 2000, 0.68, 0.494, 988, 998, 1002
6, 50, 0.52, 0.52, 26, 23, 27
6, 100, 0.3, 0.41, 41, 51, 49
6, 150, 0.38, 0.4, 60, 78, 72
6, 200, 0.32, 0.38, 76, 106, 94
6, 250, 0.38, 0.38, 95, 135, 115
6, 300, 0.38, 0.38, 114, 162, 138
6, 350, 0.44, 0.388571428571, 136, 184, 166
6, 400, 0.4, 0.39, 156, 207, 193
6, 450, 0.42, 0.393333333333, 177, 222, 228
6, 500, 0.44, 0.398, 199, 249, 251
6, 550, 0.56, 0.412727272727, 227, 272, 278
6, 600, 0.56, 0.425, 255, 297, 303
6, 650, 0.52, 0.432307692308, 281, 324, 326
6, 700, 0.54, 0.44, 308, 347, 353
6, 750, 0.42, 0.438666666667, 329, 368, 382
6, 800, 0.58, 0.4475, 358, 395, 405
6, 850, 0.54, 0.452941176471, 385, 423, 427
6, 900, 0.5, 0.455555555556, 410, 448, 452
6, 950, 0.54, 0.46, 437, 475, 475
6, 1000, 0.56, 0.465, 465, 503, 497
6, 1050, 0.48, 0.465714285714, 489, 529, 521
6, 1100, 0.46, 0.465454545455, 512, 555, 545
6, 1150, 0.46, 0.465217391304, 535, 579, 571
6, 1200, 0.48, 0.465833333333, 559, 603, 597
6, 1250, 0.5, 0.4672, 584, 629, 621
6, 1300, 0.52, 0.469230769231, 610, 655, 645
6, 1350, 0.54, 0.471851851852, 637, 683, 667
6, 1400, 0.4, 0.469285714286, 657, 708, 692
6, 1450, 0.56, 0.472413793103, 685, 732, 718
6, 1500, 0.46, 0.472, 708, 754, 746
6, 1550, 0.54, 0.474193548387, 735, 778, 772
6, 1600, 0.56, 0.476875, 763, 805, 795
6, 1650, 0.56, 0.479393939394, 791, 830, 820
6, 1700, 0.46, 0.478823529412, 814, 855, 845
6, 1750, 0.52, 0.48, 840, 880, 870
6, 1800, 0.48, 0.48, 864, 903, 897
6, 1850, 0.42, 0.478378378378, 885, 930, 920
6, 1900, 0.5, 0.478947368421, 910, 955, 945
6, 1950, 0.46, 0.478461538462, 933, 982, 968
6, 2000, 0.46, 0.478, 956, 1005, 995
7, 50, 0.28, 0.28, 14, 21, 29
7, 100, 0.34, 0.31, 31, 50, 50
7, 150, 0.26, 0.293333333333, 44, 77, 73
7, 200, 0.32, 0.3, 60, 99, 101
7, 250, 0.4, 0.32, 80, 129, 121
7, 300, 0.48, 0.346666666667, 104, 148, 152
7, 350, 0.4, 0.354285714286, 124, 178, 172
7, 400, 0.44, 0.365, 146, 205, 195
7, 450, 0.38, 0.366666666667, 165, 226, 224
7, 500, 0.44, 0.374, 187, 245, 255
7, 550, 0.4, 0.376363636364, 207, 270, 280
7, 600, 0.56, 0.391666666667, 235, 297, 303
7, 650, 0.46, 0.396923076923, 258, 319, 331
7, 700, 0.42, 0.398571428571, 279, 340, 360
7, 750, 0.6, 0.412, 309, 367, 383
7, 800, 0.52, 0.41875, 335, 396, 404
7, 850, 0.42, 0.418823529412, 356, 420, 430
7, 900, 0.46, 0.421111111111, 379, 442, 458
7, 950, 0.5, 0.425263157895, 404, 469, 481
7, 1000, 0.42, 0.425, 425, 488, 512
7, 1050, 0.5, 0.428571428571, 450, 514, 536
7, 1100, 0.54, 0.433636363636, 477, 538, 562
7, 1150, 0.42, 0.433043478261, 498, 566, 584
7, 1200, 0.54, 0.4375, 525, 596, 604
7, 1250, 0.52, 0.4408, 551, 621, 629
7, 1300, 0.48, 0.442307692308, 575, 646, 654
7, 1350, 0.54, 0.445925925926, 602, 669, 681
7, 1400, 0.36, 0.442857142857, 620, 693, 707
7, 1450, 0.48, 0.444137931034, 644, 714, 736
7, 1500, 0.5, 0.446, 669, 740, 760
7, 1550, 0.6, 0.450967741935, 699, 770, 780
7, 1600, 0.44, 0.450625, 721, 790, 810
7, 1650, 0.44, 0.450303030303, 743, 814, 836
7, 1700, 0.56, 0.453529411765, 771, 838, 862
7, 1750, 0.46, 0.453714285714, 794, 870, 880
7, 1800, 0.5, 0.455, 819, 896, 904
7, 1850, 0.58, 0.458378378378, 848, 921, 929
7, 1900, 0.5, 0.459473684211, 873, 948, 952
7, 1950, 0.5, 0.460512820513, 898, 975, 975
7, 2000, 0.5, 0.4615, 923, 1006, 994
8, 50, 0.3, 0.3, 15, 25, 25
8, 100, 0.42, 0.36, 36, 50, 50
8, 150, 0.46, 0.393333333333, 59, 79, 71
8, 200, 0.4, 0.395, 79, 100, 100
8, 250, 0.4, 0.396, 99, 124, 126
8, 300, 0.38, 0.393333333333, 118, 149, 151
8, 350, 0.44, 0.4, 140, 174, 176
8, 400, 0.36, 0.395, 158, 197, 203
8, 450, 0.52, 0.408888888889, 184, 224, 226
8, 500, 0.5, 0.418, 209, 249, 251
8, 550, 0.46, 0.421818181818, 232, 277, 273
8, 600, 0.6, 0.436666666667, 262, 300, 300
8, 650, 0.42, 0.435384615385, 283, 328, 322
8, 700, 0.5, 0.44, 308, 352, 348
8, 750, 0.46, 0.441333333333, 331, 377, 373
8, 800, 0.44, 0.44125, 353, 402, 398
8, 850, 0.52, 0.445882352941, 379, 433, 417
8, 900, 0.58, 0.453333333333, 408, 459, 441
8, 950, 0.44, 0.452631578947, 430, 482, 468
8, 1000, 0.48, 0.454, 454, 503, 497
8, 1050, 0.58, 0.46, 483, 528, 522
8, 1100, 0.52, 0.462727272727, 509, 557, 543
8, 1150, 0.46, 0.462608695652, 532, 583, 567
8, 1200, 0.48, 0.463333333333, 556, 611, 589
8, 1250, 0.4, 0.4608, 576, 641, 609
8, 1300, 0.58, 0.465384615385, 605, 667, 633
8, 1350, 0.52, 0.467407407407, 631, 698, 652
8, 1400, 0.58, 0.471428571429, 660, 725, 675
8, 1450, 0.46, 0.471034482759, 683, 746, 704
8, 1500, 0.48, 0.471333333333, 707, 770, 730
8, 1550, 0.4, 0.469032258065, 727, 796, 754
8, 1600, 0.56, 0.471875, 755, 828, 772
8, 1650, 0.5, 0.472727272727, 780, 855, 795
8, 1700, 0.58, 0.475882352941, 809, 882, 818
8, 1750, 0.46, 0.475428571429, 832, 908, 842
8, 1800, 0.5, 0.476111111111, 857, 934, 866
8, 1850, 0.44, 0.475135135135, 879, 954, 896
8, 1900, 0.54, 0.476842105263, 906, 988, 912
8, 1950, 0.5, 0.477435897436, 931, 1009, 941
8, 2000, 0.52, 0.4785, 957, 1034, 966
9, 50, 0.4, 0.4, 20, 28, 22
9, 100, 0.44, 0.42, 42, 46, 54
9, 150, 0.36, 0.4, 60, 71, 79
9, 200, 0.46, 0.415, 83, 95, 105
9, 250, 0.46, 0.424, 106, 117, 133
9, 300, 0.3, 0.403333333333, 121, 136, 164
9, 350, 0.34, 0.394285714286, 138, 159, 191
9, 400, 0.32, 0.385, 154, 183, 217
9, 450, 0.38, 0.384444444444, 173, 217, 233
9, 500, 0.56, 0.402, 201, 246, 254
9, 550, 0.56, 0.416363636364, 229, 271, 279
9, 600, 0.48, 0.421666666667, 253, 294, 306
9, 650, 0.56, 0.432307692308, 281, 323, 327
9, 700, 0.58, 0.442857142857, 310, 349, 351
9, 750, 0.52, 0.448, 336, 371, 379
9, 800, 0.44, 0.4475, 358, 391, 409
9, 850, 0.46, 0.448235294118, 381, 421, 429
9, 900, 0.46, 0.448888888889, 404, 456, 444
9, 950, 0.5, 0.451578947368, 429, 483, 467
9, 1000, 0.52, 0.455, 455, 507, 493
9, 1050, 0.54, 0.459047619048, 482, 531, 519
9, 1100, 0.46, 0.459090909091, 505, 556, 544
9, 1150, 0.52, 0.461739130435, 531, 577, 573
9, 1200, 0.5, 0.463333333333, 556, 602, 598
9, 1250, 0.6, 0.4688, 586, 632, 618
9, 1300, 0.48, 0.469230769231, 610, 662, 638
9, 1350, 0.68, 0.477037037037, 644, 696, 654
9, 1400, 0.44, 0.475714285714, 666, 723, 677
9, 1450, 0.62, 0.480689655172, 697, 752, 698
9, 1500, 0.5, 0.481333333333, 722, 779, 721
9, 1550, 0.52, 0.482580645161, 748, 805, 745
9, 1600, 0.58, 0.485625, 777, 836, 764
9, 1650, 0.58, 0.488484848485, 806, 858, 792
9, 1700, 0.42, 0.486470588235, 827, 882, 818
9, 1750, 0.4, 0.484, 847, 910, 840
9, 1800, 0.58, 0.486666666667, 876, 936, 864
9, 1850, 0.46, 0.485945945946, 899, 959, 891
9, 1900, 0.48, 0.485789473684, 923, 984, 916
9, 1950, 0.56, 0.487692307692, 951, 1009, 941
9, 2000, 0.58, 0.49, 980, 1038, 962
10, 50, 0.52, 0.52, 26, 26, 24
10, 100, 0.4, 0.46, 46, 58, 42
10, 150, 0.36, 0.426666666667, 64, 80, 70
10, 200, 0.42, 0.425, 85, 102, 98
10, 250, 0.32, 0.404, 101, 125, 125
10, 300, 0.28, 0.383333333333, 115, 149, 151
10, 350, 0.32, 0.374285714286, 131, 173, 177
10, 400, 0.46, 0.385, 154, 199, 201
10, 450, 0.56, 0.404444444444, 182, 227, 223
10, 500, 0.44, 0.408, 204, 250, 250
10, 550, 0.46, 0.412727272727, 227, 275, 275
10, 600, 0.58, 0.426666666667, 256, 302, 298
10, 650, 0.44, 0.427692307692, 278, 327, 323
10, 700, 0.48, 0.431428571429, 302, 349, 351
10, 750, 0.5, 0.436, 327, 376, 374
10, 800, 0.48, 0.43875, 351, 401, 399
10, 850, 0.6, 0.448235294118, 381, 432, 418
10, 900, 0.4, 0.445555555556, 401, 457, 443
10, 950, 0.36, 0.441052631579, 419, 484, 466
10, 1000, 0.62, 0.45, 450, 513, 487
10, 1050, 0.38, 0.446666666667, 469, 537, 513
10, 1100, 0.56, 0.451818181818, 497, 557, 543
10, 1150, 0.4, 0.449565217391, 517, 580, 570
10, 1200, 0.46, 0.45, 540, 603, 597
10, 1250, 0.58, 0.4552, 569, 624, 626
10, 1300, 0.52, 0.457692307692, 595, 642, 658
10, 1350, 0.52, 0.46, 621, 670, 680
10, 1400, 0.66, 0.467142857143, 654, 700, 700
10, 1450, 0.62, 0.472413793103, 685, 720, 730
10, 1500, 0.6, 0.476666666667, 715, 744, 756
10, 1550, 0.42, 0.474838709677, 736, 766, 784
10, 1600, 0.5, 0.475625, 761, 792, 808
10, 1650, 0.48, 0.475757575758, 785, 817, 833
10, 1700, 0.5, 0.476470588235, 810, 839, 861
10, 1750, 0.58, 0.479428571429, 839, 863, 887
10, 1800, 0.46, 0.478888888889, 862, 891, 909
10, 1850, 0.46, 0.478378378378, 885, 911, 939
10, 1900, 0.54, 0.48, 912, 933, 967
10, 1950, 0.5, 0.480512820513, 937, 959, 991
10, 2000, 0.58, 0.483, 966, 984, 1016
11, 50, 0.5, 0.5, 25, 30, 20
11, 100, 0.38, 0.44, 44, 60, 40
11, 150, 0.3, 0.393333333333, 59, 85, 65
11, 200, 0.38, 0.39, 78, 109, 91
11, 250, 0.42, 0.396, 99, 131, 119
11, 300, 0.38, 0.393333333333, 118, 155, 145
11, 350, 0.46, 0.402857142857, 141, 174, 176
11, 400, 0.44, 0.4075, 163, 202, 198
11, 450, 0.36, 0.402222222222, 181, 233, 217
11, 500, 0.5, 0.412, 206, 259, 241
11, 550, 0.56, 0.425454545455, 234, 283, 267
11, 600, 0.58, 0.438333333333, 263, 311, 289
11, 650, 0.48, 0.441538461538, 287, 332, 318
11, 700, 0.64, 0.455714285714, 319, 358, 342
11, 750, 0.44, 0.454666666667, 341, 386, 364
11, 800, 0.56, 0.46125, 369, 412, 388
11, 850, 0.62, 0.470588235294, 400, 435, 415
11, 900, 0.52, 0.473333333333, 426, 464, 436
11, 950, 0.58, 0.478947368421, 455, 487, 463
11, 1000, 0.46, 0.478, 478, 513, 487
11, 1050, 0.38, 0.473333333333, 497, 538, 512
11, 1100, 0.48, 0.473636363636, 521, 564, 536
11, 1150, 0.36, 0.468695652174, 539, 587, 563
11, 1200, 0.5, 0.47, 564, 609, 591
11, 1250, 0.56, 0.4736, 592, 634, 616
11, 1300, 0.44, 0.472307692308, 614, 656, 644
11, 1350, 0.42, 0.47037037037, 635, 683, 667
11, 1400, 0.48, 0.470714285714, 659, 711, 689
11, 1450, 0.38, 0.467586206897, 678, 729, 721
11, 1500, 0.48, 0.468, 702, 752, 748
11, 1550, 0.5, 0.469032258065, 727, 778, 772
11, 1600, 0.4, 0.466875, 747, 798, 802
11, 1650, 0.46, 0.466666666667, 770, 827, 823
11, 1700, 0.56, 0.469411764706, 798, 853, 847
11, 1750, 0.6, 0.473142857143, 828, 883, 867
11, 1800, 0.48, 0.473333333333, 852, 905, 895
11, 1850, 0.44, 0.472432432432, 874, 922, 928
11, 1900, 0.48, 0.472631578947, 898, 950, 950
11, 1950, 0.4, 0.470769230769, 918, 975, 975
11, 2000, 0.56, 0.473, 946, 999, 1001
12, 50, 0.36, 0.36, 18, 24, 26
12, 100, 0.38, 0.37, 37, 51, 49
12, 150, 0.26, 0.333333333333, 50, 78, 72
12, 200, 0.32, 0.33, 66, 99, 101
12, 250, 0.38, 0.34, 85, 119, 131
12, 300, 0.44, 0.356666666667, 107, 144, 156
12, 350, 0.48, 0.374285714286, 131, 166, 184
12, 400, 0.44, 0.3825, 153, 188, 212
12, 450, 0.42, 0.386666666667, 174, 217, 233
12, 500, 0.48, 0.396, 198, 248, 252
12, 550, 0.52, 0.407272727273, 224, 273, 277
12, 600, 0.46, 0.411666666667, 247, 303, 297
12, 650, 0.5, 0.418461538462, 272, 331, 319
12, 700, 0.46, 0.421428571429, 295, 360, 340
12, 750, 0.5, 0.426666666667, 320, 389, 361
12, 800, 0.54, 0.43375, 347, 412, 388
12, 850, 0.54, 0.44, 374, 437, 413
12, 900, 0.52, 0.444444444444, 400, 465, 435
12, 950, 0.44, 0.444210526316, 422, 489, 461
12, 1000, 0.66, 0.455, 455, 518, 482
12, 1050, 0.58, 0.460952380952, 484, 543, 507
12, 1100, 0.58, 0.466363636364, 513, 567, 533
12, 1150, 0.46, 0.466086956522, 536, 592, 558
12, 1200, 0.5, 0.4675, 561, 615, 585
12, 1250, 0.44, 0.4664, 583, 636, 614
12, 1300, 0.48, 0.466923076923, 607, 665, 635
12, 1350, 0.56, 0.47037037037, 635, 694, 656
12, 1400, 0.54, 0.472857142857, 662, 719, 681
12, 1450, 0.5, 0.473793103448, 687, 744, 706
12, 1500, 0.56, 0.476666666667, 715, 773, 727
12, 1550, 0.6, 0.48064516129, 745, 799, 751
12, 1600, 0.52, 0.481875, 771, 819, 781
12, 1650, 0.6, 0.485454545455, 801, 843, 807
12, 1700, 0.62, 0.489411764706, 832, 882, 818
12, 1750, 0.4, 0.486857142857, 852, 907, 843
12, 1800, 0.42, 0.485, 873, 930, 870
12, 1850, 0.4, 0.482702702703, 893, 947, 903
12, 1900, 0.44, 0.481578947368, 915, 967, 933
12, 1950, 0.52, 0.482564102564, 941, 994, 956
12, 2000, 0.42, 0.481, 962, 1023, 977
13, 50, 0.36, 0.36, 18, 27, 23
13, 100, 0.38, 0.37, 37, 53, 47
13, 150, 0.32, 0.353333333333, 53, 76, 74
13, 200, 0.32, 0.345, 69, 99, 101
13, 250, 0.28, 0.332, 83, 127, 123
13, 300, 0.36, 0.336666666667, 101, 152, 148
13, 350, 0.44, 0.351428571429, 123, 173, 177
13, 400, 0.48, 0.3675, 147, 201, 199
13, 450, 0.54, 0.386666666667, 174, 231, 219
13, 500, 0.7, 0.418, 209, 256, 244
13, 550, 0.48, 0.423636363636, 233, 278, 272
13, 600, 0.42, 0.423333333333, 254, 303, 297
13, 650, 0.62, 0.438461538462, 285, 332, 318
13, 700, 0.44, 0.438571428571, 307, 356, 344
13, 750, 0.44, 0.438666666667, 329, 371, 379
13, 800, 0.48, 0.44125, 353, 398, 402
13, 850, 0.44, 0.441176470588, 375, 417, 433
13, 900, 0.5, 0.444444444444, 400, 440, 460
13, 950, 0.6, 0.452631578947, 430, 467, 483
13, 1000, 0.4, 0.45, 450, 488, 512
13, 1050, 0.52, 0.453333333333, 476, 515, 535
13, 1100, 0.52, 0.456363636364, 502, 538, 562
13, 1150, 0.38, 0.453043478261, 521, 565, 585
13, 1200, 0.54, 0.456666666667, 548, 596, 604
13, 1250, 0.62, 0.4632, 579, 627, 623
13, 1300, 0.42, 0.461538461538, 600, 657, 643
13, 1350, 0.44, 0.460740740741, 622, 675, 675
13, 1400, 0.52, 0.462857142857, 648, 697, 703
13, 1450, 0.6, 0.467586206897, 678, 721, 729
13, 1500, 0.4, 0.465333333333, 698, 745, 755
13, 1550, 0.5, 0.466451612903, 723, 766, 784
13, 1600, 0.52, 0.468125, 749, 790, 810
13, 1650, 0.54, 0.470303030303, 776, 814, 836
13, 1700, 0.5, 0.471176470588, 801, 841, 859
13, 1750, 0.5, 0.472, 826, 867, 883
13, 1800, 0.48, 0.472222222222, 850, 894, 906
13, 1850, 0.56, 0.474594594595, 878, 922, 928
13, 1900, 0.38, 0.472105263158, 897, 951, 949
13, 1950, 0.48, 0.472307692308, 921, 973, 977
13, 2000, 0.42, 0.471, 942, 994, 1006
14, 50, 0.32, 0.32, 16, 32, 18
14, 100, 0.38, 0.35, 35, 51, 49
14, 150, 0.34, 0.346666666667, 52, 75, 75
14, 200, 0.4, 0.36, 72, 103, 97
14, 250, 0.4, 0.368, 92, 132, 118
14, 300, 0.44, 0.38, 114, 156, 144
14, 350, 0.38, 0.38, 133, 182, 168
14, 400, 0.48, 0.3925, 157, 206, 194
14, 450, 0.58, 0.413333333333, 186, 231, 219
14, 500, 0.52, 0.424, 212, 257, 243
14, 550, 0.66, 0.445454545455, 245, 283, 267
14, 600, 0.4, 0.441666666667, 265, 304, 296
14, 650, 0.58, 0.452307692308, 294, 327, 323
14, 700, 0.4, 0.448571428571, 314, 351, 349
14, 750, 0.5, 0.452, 339, 382, 368
14, 800, 0.48, 0.45375, 363, 412, 388
14, 850, 0.44, 0.452941176471, 385, 437, 413
14, 900, 0.56, 0.458888888889, 413, 464, 436
14, 950, 0.46, 0.458947368421, 436, 485, 465
14, 1000, 0.5, 0.461, 461, 511, 489
14, 1050, 0.5, 0.462857142857, 486, 534, 516
14, 1100, 0.52, 0.465454545455, 512, 561, 539
14, 1150, 0.42, 0.46347826087, 533, 587, 563
14, 1200, 0.54, 0.466666666667, 560, 616, 584
14, 1250, 0.58, 0.4712, 589, 646, 604
14, 1300, 0.52, 0.473076923077, 615, 676, 624
14, 1350, 0.6, 0.477777777778, 645, 697, 653
14, 1400, 0.64, 0.483571428571, 677, 726, 674
14, 1450, 0.52, 0.484827586207, 703, 751, 699
14, 1500, 0.52, 0.486, 729, 779, 721
14, 1550, 0.36, 0.481935483871, 747, 797, 753
14, 1600, 0.62, 0.48625, 778, 826, 774
14, 1650, 0.64, 0.490909090909, 810, 855, 795
14, 1700, 0.52, 0.491764705882, 836, 885, 815
14, 1750, 0.48, 0.491428571429, 860, 908, 842
14, 1800, 0.54, 0.492777777778, 887, 936, 864
14, 1850, 0.48, 0.492432432432, 911, 959, 891
14, 1900, 0.46, 0.491578947368, 934, 984, 916
14, 1950, 0.4, 0.489230769231, 954, 1007, 943
14, 2000, 0.46, 0.4885, 977, 1032, 968
15, 50, 0.34, 0.34, 17, 27, 23
15, 100, 0.36, 0.35, 35, 62, 38
15, 150, 0.44, 0.38, 57, 86, 64
15, 200, 0.44, 0.395, 79, 110, 90
15, 250, 0.3, 0.376, 94, 138, 112
15, 300, 0.32, 0.366666666667, 110, 170, 130
15, 350, 0.36, 0.365714285714, 128, 191, 159
15, 400, 0.38, 0.3675, 147, 214, 186
15, 450, 0.48, 0.38, 171, 238, 212
15, 500, 0.5, 0.392, 196, 263, 237
15, 550, 0.7, 0.42, 231, 293, 257
15, 600, 0.42, 0.42, 252, 320, 280
15, 650, 0.58, 0.432307692308, 281, 345, 305
15, 700, 0.52, 0.438571428571, 307, 374, 326
15, 750, 0.42, 0.437333333333, 328, 401, 349
15, 800, 0.56, 0.445, 356, 428, 372
15, 850, 0.44, 0.444705882353, 378, 450, 400
15, 900, 0.46, 0.445555555556, 401, 474, 426
15, 950, 0.52, 0.449473684211, 427, 499, 451
15, 1000, 0.56, 0.455, 455, 529, 471
15, 1050, 0.44, 0.454285714286, 477, 555, 495
15, 1100, 0.64, 0.462727272727, 509, 580, 520
15, 1150, 0.42, 0.460869565217, 530, 604, 546
15, 1200, 0.42, 0.459166666667, 551, 634, 566
15, 1250, 0.46, 0.4592, 574, 664, 586
15, 1300, 0.56, 0.463076923077, 602, 691, 609
15, 1350, 0.46, 0.462962962963, 625, 721, 629
15, 1400, 0.52, 0.465, 651, 744, 656
15, 1450, 0.4, 0.46275862069, 671, 767, 683
15, 1500, 0.62, 0.468, 702, 792, 708
15, 1550, 0.58, 0.471612903226, 731, 814, 736
15, 1600, 0.52, 0.473125, 757, 837, 763
15, 1650, 0.5, 0.473939393939, 782, 859, 791
15, 1700, 0.44, 0.472941176471, 804, 888, 812
15, 1750, 0.48, 0.473142857143, 828, 917, 833
15, 1800, 0.58, 0.476111111111, 857, 948, 852
15, 1850, 0.46, 0.475675675676, 880, 971, 879
15, 1900, 0.5, 0.476315789474, 905, 1001, 899
15, 1950, 0.5, 0.476923076923, 930, 1033, 917
15, 2000, 0.42, 0.4755, 951, 1050, 950
16, 50, 0.42, 0.42, 21, 27, 23
16, 100, 0.26, 0.34, 34, 47, 53
16, 150, 0.36, 0.346666666667, 52, 65, 85
16, 200, 0.52, 0.39, 78, 86, 114
16, 250, 0.32, 0.376, 94, 107, 143
16, 300, 0.44, 0.386666666667, 116, 131, 169
16, 350, 0.38, 0.385714285714, 135, 159, 191
16, 400, 0.46, 0.395, 158, 186, 214
16, 450, 0.42, 0.397777777778, 179, 215, 235
16, 500, 0.44, 0.402, 201, 237, 263
16, 550, 0.6, 0.42, 231, 264, 286
16, 600, 0.48, 0.425, 255, 290, 310
16, 650, 0.4, 0.423076923077, 275, 312, 338
16, 700, 0.44, 0.424285714286, 297, 334, 366
16, 750, 0.32, 0.417333333333, 313, 359, 391
16, 800, 0.46, 0.42, 336, 383, 417
16, 850, 0.34, 0.415294117647, 353, 401, 449
16, 900, 0.46, 0.417777777778, 376, 419, 481
16, 950, 0.48, 0.421052631579, 400, 450, 500
16, 1000, 0.56, 0.428, 428, 479, 521
16, 1050, 0.38, 0.425714285714, 447, 506, 544
16, 1100, 0.44, 0.426363636364, 469, 530, 570
16, 1150, 0.54, 0.431304347826, 496, 557, 593
16, 1200, 0.38, 0.429166666667, 515, 583, 617
16, 1250, 0.52, 0.4328, 541, 609, 641
16, 1300, 0.5, 0.435384615385, 566, 637, 663
16, 1350, 0.46, 0.436296296296, 589, 661, 689
16, 1400, 0.32, 0.432142857143, 605, 686, 714
16, 1450, 0.48, 0.433793103448, 629, 712, 738
16, 1500, 0.52, 0.436666666667, 655, 735, 765
16, 1550, 0.66, 0.443870967742, 688, 764, 786
16, 1600, 0.64, 0.45, 720, 794, 806
16, 1650, 0.46, 0.450303030303, 743, 822, 828
16, 1700, 0.48, 0.451176470588, 767, 852, 848
16, 1750, 0.48, 0.452, 791, 881, 869
16, 1800, 0.42, 0.451111111111, 812, 909, 891
16, 1850, 0.52, 0.452972972973, 838, 929, 921
16, 1900, 0.42, 0.452105263158, 859, 955, 945
16, 1950, 0.48, 0.452820512821, 883, 984, 966
16, 2000, 0.38, 0.451, 902, 1009, 991
17, 50, 0.28, 0.28, 14, 23, 27
17, 100, 0.34, 0.31, 31, 44, 56
17, 150, 0.4, 0.34, 51, 63, 87
17, 200, 0.32, 0.335, 67, 87, 113
17, 250, 0.48, 0.364, 91, 113, 137
17, 300, 0.34, 0.36, 108, 134, 166
17, 350, 0.4, 0.365714285714, 128, 156, 194
17, 400, 0.28, 0.355, 142, 179, 221
17, 450, 0.4, 0.36, 162, 206, 244
17, 500, 0.46, 0.37, 185, 235, 265
17, 550, 0.44, 0.376363636364, 207, 263, 287
17, 600, 0.58, 0.393333333333, 236, 291, 309
17, 650, 0.6, 0.409230769231, 266, 310, 340
17, 700, 0.56, 0.42, 294, 333, 367
17, 750, 0.42, 0.42, 315, 365, 385
17, 800, 0.54, 0.4275, 342, 392, 408
17, 850, 0.5, 0.431764705882, 367, 423, 427
17, 900, 0.64, 0.443333333333, 399, 450, 450
17, 950, 0.52, 0.447368421053, 425, 477, 473
17, 1000, 0.44, 0.447, 447, 509, 491
17, 1050, 0.64, 0.45619047619, 479, 537, 513
17, 1100, 0.46, 0.456363636364, 502, 562, 538
17, 1150, 0.48, 0.457391304348, 526, 582, 568
17, 1200, 0.5, 0.459166666667, 551, 608, 592
17, 1250, 0.48, 0.46, 575, 635, 615
17, 1300, 0.52, 0.462307692308, 601, 657, 643
17, 1350, 0.4, 0.46, 621, 683, 667
17, 1400, 0.48, 0.460714285714, 645, 704, 696
17, 1450, 0.46, 0.460689655172, 668, 729, 721
17, 1500, 0.34, 0.456666666667, 685, 755, 745
17, 1550, 0.46, 0.456774193548, 708, 781, 769
17, 1600, 0.54, 0.459375, 735, 803, 797
17, 1650, 0.54, 0.461818181818, 762, 827, 823
17, 1700, 0.52, 0.463529411765, 788, 854, 846
17, 1750, 0.4, 0.461714285714, 808, 879, 871
17, 1800, 0.4, 0.46, 828, 902, 898
17, 1850, 0.44, 0.459459459459, 850, 927, 923
17, 1900, 0.46, 0.459473684211, 873, 950, 950
17, 1950, 0.58, 0.462564102564, 902, 976, 974
17, 2000, 0.48, 0.463, 926, 1001, 999
18, 50, 0.38, 0.38, 19, 30, 20
18, 100, 0.38, 0.38, 38, 56, 44
18, 150, 0.38, 0.38, 57, 76, 74
18, 200, 0.4, 0.385, 77, 97, 103
18, 250, 0.48, 0.404, 101, 126, 124
18, 300, 0.42, 0.406666666667, 122, 149, 151
18, 350, 0.26, 0.385714285714, 135, 176, 174
18, 400, 0.54, 0.405, 162, 201, 199
18, 450, 0.38, 0.402222222222, 181, 231, 219
18, 500, 0.52, 0.414, 207, 254, 246
18, 550, 0.52, 0.423636363636, 233, 280, 270
18, 600, 0.42, 0.423333333333, 254, 297, 303
18, 650, 0.4, 0.421538461538, 274, 326, 324
18, 700, 0.58, 0.432857142857, 303, 348, 352
18, 750, 0.42, 0.432, 324, 370, 380
18, 800, 0.5, 0.43625, 349, 394, 406
18, 850, 0.44, 0.436470588235, 371, 413, 437
18, 900, 0.6, 0.445555555556, 401, 432, 468
18, 950, 0.5, 0.448421052632, 426, 458, 492
18, 1000, 0.6, 0.456, 456, 478, 522
18, 1050, 0.48, 0.457142857143, 480, 505, 545
18, 1100, 0.54, 0.460909090909, 507, 532, 568
18, 1150, 0.46, 0.460869565217, 530, 555, 595
18, 1200, 0.48, 0.461666666667, 554, 585, 615
18, 1250, 0.52, 0.464, 580, 610, 640
18, 1300, 0.5, 0.465384615385, 605, 632, 668
18, 1350, 0.44, 0.464444444444, 627, 658, 692
18, 1400, 0.44, 0.463571428571, 649, 678, 722
18, 1450, 0.44, 0.46275862069, 671, 702, 748
18, 1500, 0.52, 0.464666666667, 697, 731, 769
18, 1550, 0.54, 0.467096774194, 724, 755, 795
18, 1600, 0.4, 0.465, 744, 777, 823
18, 1650, 0.56, 0.467878787879, 772, 798, 852
18, 1700, 0.46, 0.467647058824, 795, 818, 882
18, 1750, 0.6, 0.471428571429, 825, 841, 909
18, 1800, 0.56, 0.473888888889, 853, 858, 942
18, 1850, 0.48, 0.474054054054, 877, 884, 966
18, 1900, 0.5, 0.474736842105, 902, 910, 990
18, 1950, 0.44, 0.473846153846, 924, 933, 1017
18, 2000, 0.52, 0.475, 950, 959, 1041
19, 50, 0.38, 0.38, 19, 24, 26
19, 100, 0.42, 0.4, 40, 50, 50
19, 150, 0.5, 0.433333333333, 65, 75, 75
19, 200, 0.52, 0.455, 91, 100, 100
19, 250, 0.42, 0.448, 112, 123, 127
19, 300, 0.48, 0.453333333333, 136, 146, 154
19, 350, 0.32, 0.434285714286, 152, 175, 175
19, 400, 0.42, 0.4325, 173, 199, 201
19, 450, 0.54, 0.444444444444, 200, 222, 228
19, 500, 0.64, 0.464, 232, 250, 250
19, 550, 0.56, 0.472727272727, 260, 279, 271
19, 600, 0.56, 0.48, 288, 307, 293
19, 650, 0.6, 0.489230769231, 318, 333, 317
19, 700, 0.52, 0.491428571429, 344, 359, 341
19, 750, 0.52, 0.493333333333, 370, 383, 367
19, 800, 0.4, 0.4875, 390, 406, 394
19, 850, 0.48, 0.487058823529, 414, 430, 420
19, 900, 0.54, 0.49, 441, 456, 444
19, 950, 0.46, 0.488421052632, 464, 483, 467
19, 1000, 0.62, 0.495, 495, 504, 496
19, 1050, 0.38, 0.489523809524, 514, 529, 521
19, 1100, 0.66, 0.497272727273, 547, 557, 543
19, 1150, 0.56, 0.5, 575, 582, 568
19, 1200, 0.42, 0.496666666667, 596, 607, 593
19, 1250, 0.4, 0.4928, 616, 632, 618
19, 1300, 0.48, 0.492307692308, 640, 658, 642
19, 1350, 0.62, 0.497037037037, 671, 679, 671
19, 1400, 0.48, 0.496428571429, 695, 700, 700
19, 1450, 0.32, 0.490344827586, 711, 721, 729
19, 1500, 0.48, 0.49, 735, 749, 751
19, 1550, 0.54, 0.491612903226, 762, 773, 777
19, 1600, 0.48, 0.49125, 786, 793, 807
19, 1650, 0.5, 0.491515151515, 811, 822, 828
19, 1700, 0.44, 0.49, 833, 845, 855
19, 1750, 0.42, 0.488, 854, 870, 880
19, 1800, 0.6, 0.491111111111, 884, 891, 909
19, 1850, 0.5, 0.491351351351, 909, 914, 936
19, 1900, 0.58, 0.493684210526, 938, 933, 967
19, 1950, 0.42, 0.491794871795, 959, 960, 990
19, 2000, 0.5, 0.492, 984, 992, 1008
20, 50, 0.3, 0.3, 15, 32, 18
20, 100, 0.5, 0.4, 40, 55, 45
20, 150, 0.4, 0.4, 60, 79, 71
20, 200, 0.28, 0.37, 74, 100, 100
20, 250, 0.54, 0.404, 101, 123, 127
20, 300, 0.26, 0.38, 114, 149, 151
20, 350, 0.32, 0.371428571429, 130, 170, 180
20, 400, 0.34, 0.3675, 147, 194, 206
20, 450, 0.52, 0.384444444444, 173, 216, 234
20, 500, 0.5, 0.396, 198, 244, 256
20, 550, 0.5, 0.405454545455, 223, 271, 279
20, 600, 0.64, 0.425, 255, 297, 303
20, 650, 0.6, 0.438461538462, 285, 327, 323
20, 700, 0.38, 0.434285714286, 304, 351, 349
20, 750, 0.48, 0.437333333333, 328, 376, 374
20, 800, 0.44, 0.4375, 350, 397, 403
20, 850, 0.4, 0.435294117647, 370, 420, 430
20, 900, 0.34, 0.43, 387, 446, 454
20, 950, 0.6, 0.438947368421, 417, 473, 477
20, 1000, 0.4, 0.437, 437, 498, 502
20, 1050, 0.6, 0.444761904762, 467, 525, 525
20, 1100, 0.5, 0.447272727273, 492, 552, 548
20, 1150, 0.54, 0.451304347826, 519, 577, 573
20, 1200, 0.44, 0.450833333333, 541, 601, 599
20, 1250, 0.58, 0.456, 570, 625, 625
20, 1300, 0.32, 0.450769230769, 586, 650, 650
20, 1350, 0.44, 0.45037037037, 608, 672, 678
20, 1400, 0.5, 0.452142857143, 633, 695, 705
20, 1450, 0.6, 0.45724137931, 663, 722, 728
20, 1500, 0.48, 0.458, 687, 751, 749
20, 1550, 0.4, 0.456129032258, 707, 771, 779
20, 1600, 0.5, 0.4575, 732, 799, 801
20, 1650, 0.56, 0.460606060606, 760, 823, 827
20, 1700, 0.58, 0.464117647059, 789, 847, 853
20, 1750, 0.5, 0.465142857143, 814, 871, 879
20, 1800, 0.52, 0.466666666667, 840, 897, 903
20, 1850, 0.56, 0.469189189189, 868, 928, 922
20, 1900, 0.44, 0.468421052632, 890, 953, 947
20, 1950, 0.58, 0.471282051282, 919, 981, 969
20, 2000, 0.46, 0.471, 942, 1007, 993
21, 50, 0.4, 0.4, 20, 23, 27
21, 100, 0.36, 0.38, 38, 54, 46
21, 150, 0.26, 0.34, 51, 81, 69
21, 200, 0.38, 0.35, 70, 111, 89
21, 250, 0.38, 0.356, 89, 139, 111
21, 300, 0.22, 0.333333333333, 100, 153, 147
21, 350, 0.4, 0.342857142857, 120, 175, 175
21, 400, 0.34, 0.3425, 137, 196, 204
21, 450, 0.48, 0.357777777778, 161, 227, 223
21, 500, 0.48, 0.37, 185, 256, 244
21, 550, 0.5, 0.381818181818, 210, 282, 268
21, 600, 0.5, 0.391666666667, 235, 306, 294
21, 650, 0.54, 0.403076923077, 262, 335, 315
21, 700, 0.6, 0.417142857143, 292, 367, 333
21, 750, 0.46, 0.42, 315, 397, 353
21, 800, 0.54, 0.4275, 342, 423, 377
21, 850, 0.52, 0.432941176471, 368, 450, 400
21, 900, 0.54, 0.438888888889, 395, 468, 432
21, 950, 0.58, 0.446315789474, 424, 491, 459
21, 1000, 0.4, 0.444, 444, 517, 483
21, 1050, 0.48, 0.445714285714, 468, 542, 508
21, 1100, 0.52, 0.449090909091, 494, 565, 535
21, 1150, 0.5, 0.451304347826, 519, 593, 557
21, 1200, 0.48, 0.4525, 543, 618, 582
21, 1250, 0.52, 0.4552, 569, 643, 607
21, 1300, 0.58, 0.46, 598, 670, 630
21, 1350, 0.52, 0.462222222222, 624, 698, 652
21, 1400, 0.54, 0.465, 651, 721, 679
21, 1450, 0.48, 0.465517241379, 675, 748, 702
21, 1500, 0.54, 0.468, 702, 773, 727
21, 1550, 0.5, 0.469032258065, 727, 797, 753
21, 1600, 0.56, 0.471875, 755, 822, 778
21, 1650, 0.5, 0.472727272727, 780, 851, 799
21, 1700, 0.48, 0.472941176471, 804, 874, 826
21, 1750, 0.5, 0.473714285714, 829, 897, 853
21, 1800, 0.5, 0.474444444444, 854, 916, 884
21, 1850, 0.62, 0.478378378378, 885, 947, 903
21, 1900, 0.5, 0.478947368421, 910, 973, 927
21, 1950, 0.5, 0.479487179487, 935, 1008, 942
21, 2000, 0.48, 0.4795, 959, 1028, 972
22, 50, 0.4, 0.4, 20, 20, 30
22, 100, 0.42, 0.41, 41, 33, 67
22, 150, 0.42, 0.413333333333, 62, 57, 93
22, 200, 0.44, 0.42, 84, 83, 117
22, 250, 0.42, 0.42, 105, 112, 138
22, 300, 0.4, 0.416666666667, 125, 137, 163
22, 350, 0.34, 0.405714285714, 142, 166, 184
22, 400, 0.5, 0.4175, 167, 190, 210
22, 450, 0.44, 0.42, 189, 215, 235
22, 500, 0.54, 0.432, 216, 243, 257
22, 550, 0.48, 0.436363636364, 240, 265, 285
22, 600, 0.48, 0.44, 264, 289, 311
22, 650, 0.54, 0.447692307692, 291, 314, 336
22, 700, 0.48, 0.45, 315, 337, 363
22, 750, 0.52, 0.454666666667, 341, 371, 379
22, 800, 0.5, 0.4575, 366, 390, 410
22, 850, 0.58, 0.464705882353, 395, 418, 432
22, 900, 0.6, 0.472222222222, 425, 444, 456
22, 950, 0.48, 0.472631578947, 449, 472, 478
22, 1000, 0.48, 0.473, 473, 494, 506
22, 1050, 0.62, 0.48, 504, 527, 523
22, 1100, 0.52, 0.481818181818, 530, 555, 545
22, 1150, 0.4, 0.478260869565, 550, 579, 571
22, 1200, 0.52, 0.48, 576, 602, 598
22, 1250, 0.62, 0.4856, 607, 629, 621
22, 1300, 0.52, 0.486923076923, 633, 663, 637
22, 1350, 0.54, 0.488888888889, 660, 690, 660
22, 1400, 0.52, 0.49, 686, 711, 689
22, 1450, 0.4, 0.486896551724, 706, 732, 718
22, 1500, 0.36, 0.482666666667, 724, 757, 743
22, 1550, 0.48, 0.482580645161, 748, 784, 766
22, 1600, 0.5, 0.483125, 773, 806, 794
22, 1650, 0.5, 0.483636363636, 798, 837, 813
22, 1700, 0.48, 0.483529411765, 822, 860, 840
22, 1750, 0.5, 0.484, 847, 885, 865
22, 1800, 0.44, 0.482777777778, 869, 909, 891
22, 1850, 0.46, 0.482162162162, 892, 934, 916
22, 1900, 0.28, 0.476842105263, 906, 959, 941
22, 1950, 0.5, 0.477435897436, 931, 985, 965
22, 2000, 0.38, 0.475, 950, 1005, 995
23, 50, 0.56, 0.56, 28, 24, 26
23, 100, 0.44, 0.5, 50, 51, 49
23, 150, 0.4, 0.466666666667, 70, 75, 75
23, 200, 0.38, 0.445, 89, 98, 102
23, 250, 0.4, 0.436, 109, 118, 132
23, 300, 0.44, 0.436666666667, 131, 147, 153
23, 350, 0.34, 0.422857142857, 148, 170, 180
23, 400, 0.36, 0.415, 166, 193, 207
23, 450, 0.44, 0.417777777778, 188, 219, 231
23, 500, 0.32, 0.408, 204, 242, 258
23, 550, 0.56, 0.421818181818, 232, 270, 280
23, 600, 0.54, 0.431666666667, 259, 295, 305
23, 650, 0.46, 0.433846153846, 282, 317, 333
23, 700, 0.52, 0.44, 308, 336, 364
23, 750, 0.54, 0.446666666667, 335, 364, 386
23, 800, 0.58, 0.455, 364, 392, 408
23, 850, 0.5, 0.457647058824, 389, 415, 435
23, 900, 0.52, 0.461111111111, 415, 438, 462
23, 950, 0.56, 0.466315789474, 443, 466, 484
23, 1000, 0.34, 0.46, 460, 490, 510
23, 1050, 0.52, 0.462857142857, 486, 512, 538
23, 1100, 0.42, 0.460909090909, 507, 536, 564
23, 1150, 0.6, 0.466956521739, 537, 562, 588
23, 1200, 0.48, 0.4675, 561, 584, 616
23, 1250, 0.36, 0.4632, 579, 609, 641
23, 1300, 0.54, 0.466153846154, 606, 635, 665
23, 1350, 0.62, 0.471851851852, 637, 660, 690
23, 1400, 0.5, 0.472857142857, 662, 694, 706
23, 1450, 0.48, 0.473103448276, 686, 721, 729
23, 1500, 0.48, 0.473333333333, 710, 743, 757
23, 1550, 0.48, 0.473548387097, 734, 774, 776
23, 1600, 0.48, 0.47375, 758, 798, 802
23, 1650, 0.44, 0.472727272727, 780, 820, 830
23, 1700, 0.48, 0.472941176471, 804, 848, 852
23, 1750, 0.5, 0.473714285714, 829, 875, 875
23, 1800, 0.48, 0.473888888889, 853, 903, 897
23, 1850, 0.56, 0.476216216216, 881, 931, 919
23, 1900, 0.5, 0.476842105263, 906, 953, 947
23, 1950, 0.32, 0.472820512821, 922, 973, 977
23, 2000, 0.5, 0.4735, 947, 1001, 999
24, 50, 0.28, 0.28, 14, 28, 22
24, 100, 0.3, 0.29, 29, 51, 49
24, 150, 0.3, 0.293333333333, 44, 81, 69
24, 200, 0.36, 0.31, 62, 104, 96
24, 250, 0.46, 0.34, 85, 126, 124
24, 300, 0.46, 0.36, 108, 148, 152
24, 350, 0.32, 0.354285714286, 124, 168, 182
24, 400, 0.46, 0.3675, 147, 196, 204
24, 450, 0.28, 0.357777777778, 161, 218, 232
24, 500, 0.48, 0.37, 185, 242, 258
24, 550, 0.42, 0.374545454545, 206, 264, 286
24, 600, 0.66, 0.398333333333, 239, 288, 312
24, 650, 0.64, 0.416923076923, 271, 317, 333
24, 700, 0.52, 0.424285714286, 297, 346, 354
24, 750, 0.5, 0.429333333333, 322, 374, 376
24, 800, 0.62, 0.44125, 353, 400, 400
24, 850, 0.58, 0.449411764706, 382, 424, 426
24, 900, 0.48, 0.451111111111, 406, 451, 449
24, 950, 0.64, 0.461052631579, 438, 476, 474
24, 1000, 0.54, 0.465, 465, 503, 497
24, 1050, 0.6, 0.471428571429, 495, 527, 523
24, 1100, 0.48, 0.471818181818, 519, 551, 549
24, 1150, 0.54, 0.474782608696, 546, 579, 571
24, 1200, 0.56, 0.478333333333, 574, 603, 597
24, 1250, 0.52, 0.48, 600, 626, 624
24, 1300, 0.42, 0.477692307692, 621, 649, 651
24, 1350, 0.6, 0.482222222222, 651, 672, 678
24, 1400, 0.4, 0.479285714286, 671, 700, 700
24, 1450, 0.54, 0.481379310345, 698, 730, 720
24, 1500, 0.5, 0.482, 723, 753, 747
24, 1550, 0.48, 0.481935483871, 747, 779, 771
24, 1600, 0.48, 0.481875, 771, 807, 793
24, 1650, 0.56, 0.484242424242, 799, 828, 822
24, 1700, 0.48, 0.484117647059, 823, 849, 851
24, 1750, 0.48, 0.484, 847, 875, 875
24, 1800, 0.44, 0.482777777778, 869, 901, 899
24, 1850, 0.48, 0.482702702703, 893, 923, 927
24, 1900, 0.54, 0.484210526316, 920, 944, 956
24, 1950, 0.5, 0.484615384615, 945, 965, 985
24, 2000, 0.58, 0.487, 974, 999, 1001
25, 50, 0.36, 0.36, 18, 25, 25
25, 100, 0.4, 0.38, 38, 47, 53
25, 150, 0.46, 0.406666666667, 61, 76, 74
25, 200, 0.44, 0.415, 83, 107, 93
25, 250, 0.42, 0.416, 104, 138, 112
25, 300, 0.34, 0.403333333333, 121, 159, 141
25, 350, 0.5, 0.417142857143, 146, 178, 172
25, 400, 0.28, 0.4, 160, 200, 200
25, 450, 0.52, 0.413333333333, 186, 223, 227
25, 500, 0.42, 0.414, 207, 240, 260
25, 550, 0.5, 0.421818181818, 232, 261, 289
25, 600, 0.46, 0.425, 255, 288, 312
25, 650, 0.52, 0.432307692308, 281, 311, 339
25, 700, 0.44, 0.432857142857, 303, 334, 366
25, 750, 0.6, 0.444, 333, 364, 386
25, 800, 0.6, 0.45375, 363, 392, 408
25, 850, 0.58, 0.461176470588, 392, 416, 434
25, 900, 0.5, 0.463333333333, 417, 440, 460
25, 950, 0.48, 0.464210526316, 441, 457, 493
25, 1000, 0.5, 0.466, 466, 487, 513
25, 1050, 0.4, 0.462857142857, 486, 510, 540
25, 1100, 0.62, 0.47, 517, 534, 566
25, 1150, 0.5, 0.471304347826, 542, 559, 591
25, 1200, 0.44, 0.47, 564, 584, 616
25, 1250, 0.58, 0.4744, 593, 610, 640
25, 1300, 0.46, 0.473846153846, 616, 630, 670
25, 1350, 0.52, 0.475555555556, 642, 660, 690
25, 1400, 0.48, 0.475714285714, 666, 684, 716
25, 1450, 0.56, 0.478620689655, 694, 705, 745
25, 1500, 0.6, 0.482666666667, 724, 731, 769
25, 1550, 0.5, 0.483225806452, 749, 755, 795
25, 1600, 0.4, 0.480625, 769, 779, 821
25, 1650, 0.52, 0.481818181818, 795, 803, 847
25, 1700, 0.42, 0.48, 816, 830, 870
25, 1750, 0.54, 0.481714285714, 843, 852, 898
25, 1800, 0.6, 0.485, 873, 877, 923
25, 1850, 0.48, 0.484864864865, 897, 901, 949
25, 1900, 0.5, 0.485263157895, 922, 931, 969
25, 1950, 0.46, 0.484615384615, 945, 955, 995
25, 2000, 0.4, 0.4825, 965, 970, 1030
26, 50, 0.28, 0.28, 14, 22, 28
26, 100, 0.26, 0.27, 27, 52, 48
26, 150, 0.38, 0.306666666667, 46, 73, 77
26, 200, 0.38, 0.325, 65, 95, 105
26, 250, 0.36, 0.332, 83, 120, 130
26, 300, 0.34, 0.333333333333, 100, 139, 161
26, 350, 0.3, 0.328571428571, 115, 165, 185
26, 400, 0.4, 0.3375, 135, 192, 208
26, 450, 0.56, 0.362222222222, 163, 218, 232
26, 500, 0.64, 0.39, 195, 245, 255
26, 550, 0.46, 0.396363636364, 218, 272, 278
26, 600, 0.48, 0.403333333333, 242, 297, 303
26, 650, 0.5, 0.410769230769, 267, 320, 330
26, 700, 0.54, 0.42, 294, 342, 358
26, 750, 0.48, 0.424, 318, 373, 377
26, 800, 0.4, 0.4225, 338, 395, 405
26, 850, 0.46, 0.424705882353, 361, 421, 429
26, 900, 0.5, 0.428888888889, 386, 452, 448
26, 950, 0.44, 0.429473684211, 408, 481, 469
26, 1000, 0.54, 0.435, 435, 514, 486
26, 1050, 0.46, 0.43619047619, 458, 537, 513
26, 1100, 0.38, 0.433636363636, 477, 560, 540
26, 1150, 0.48, 0.435652173913, 501, 582, 568
26, 1200, 0.52, 0.439166666667, 527, 609, 591
26, 1250, 0.54, 0.4432, 554, 627, 623
26, 1300, 0.56, 0.447692307692, 582, 654, 646
26, 1350, 0.4, 0.445925925926, 602, 673, 677
26, 1400, 0.44, 0.445714285714, 624, 694, 706
26, 1450, 0.48, 0.446896551724, 648, 722, 728
26, 1500, 0.44, 0.446666666667, 670, 739, 761
26, 1550, 0.52, 0.449032258065, 696, 763, 787
26, 1600, 0.52, 0.45125, 722, 784, 816
26, 1650, 0.44, 0.450909090909, 744, 808, 842
26, 1700, 0.58, 0.454705882353, 773, 834, 866
26, 1750, 0.58, 0.458285714286, 802, 866, 884
26, 1800, 0.52, 0.46, 828, 891, 909
26, 1850, 0.48, 0.460540540541, 852, 912, 938
26, 1900, 0.52, 0.462105263158, 878, 938, 962
26, 1950, 0.5, 0.463076923077, 903, 958, 992
26, 2000, 0.6, 0.4665, 933, 985, 1015
27, 50, 0.44, 0.44, 22, 24, 26
27, 100, 0.28, 0.36, 36, 50, 50
27, 150, 0.54, 0.42, 63, 76, 74
27, 200, 0.42, 0.42, 84, 102, 98
27, 250, 0.34, 0.404, 101, 127, 123
27, 300, 0.58, 0.433333333333, 130, 148, 152
27, 350, 0.32, 0.417142857143, 146, 181, 169
27, 400, 0.32, 0.405, 162, 204, 196
27, 450, 0.58, 0.424444444444, 191, 229, 221
27, 500, 0.52, 0.434, 217, 256, 244
27, 550, 0.52, 0.441818181818, 243, 286, 264
27, 600, 0.48, 0.445, 267, 317, 283
27, 650, 0.6, 0.456923076923, 297, 341, 309
27, 700, 0.4, 0.452857142857, 317, 362, 338
27, 750, 0.56, 0.46, 345, 383, 367
27, 800, 0.52, 0.46375, 371, 404, 396
27, 850, 0.6, 0.471764705882, 401, 427, 423
27, 900, 0.54, 0.475555555556, 428, 449, 451
27, 950, 0.42, 0.472631578947, 449, 473, 477
27, 1000, 0.56, 0.477, 477, 502, 498
27, 1050, 0.52, 0.479047619048, 503, 527, 523
27, 1100, 0.48, 0.479090909091, 527, 552, 548
27, 1150, 0.58, 0.48347826087, 556, 576, 574
27, 1200, 0.52, 0.485, 582, 598, 602
27, 1250, 0.4, 0.4816, 602, 622, 628
27, 1300, 0.46, 0.480769230769, 625, 646, 654
27, 1350, 0.38, 0.477037037037, 644, 666, 684
27, 1400, 0.52, 0.478571428571, 670, 690, 710
27, 1450, 0.58, 0.482068965517, 699, 718, 732
27, 1500, 0.6, 0.486, 729, 747, 753
27, 1550, 0.56, 0.488387096774, 757, 769, 781
27, 1600, 0.54, 0.49, 784, 800, 800
27, 1650, 0.48, 0.489696969697, 808, 826, 824
27, 1700, 0.58, 0.492352941176, 837, 849, 851
27, 1750, 0.3, 0.486857142857, 852, 872, 878
27, 1800, 0.38, 0.483888888889, 871, 896, 904
27, 1850, 0.56, 0.485945945946, 899, 923, 927
27, 1900, 0.64, 0.49, 931, 944, 956
27, 1950, 0.52, 0.490769230769, 957, 968, 982
27, 2000, 0.58, 0.493, 986, 993, 1007
28, 50, 0.48, 0.48, 24, 20, 30
28, 100, 0.36, 0.42, 42, 38, 62
28, 150, 0.28, 0.373333333333, 56, 66, 84
28, 200, 0.36, 0.37, 74, 89, 111
28, 250, 0.32, 0.36, 90, 123, 127
28, 300, 0.38, 0.363333333333, 109, 152, 148
28, 350, 0.48, 0.38, 133, 172, 178
28, 400, 0.22, 0.36, 144, 194, 206
28, 450, 0.52, 0.377777777778, 170, 217, 233
28, 500, 0.54, 0.394, 197, 242, 258
28, 550, 0.48, 0.401818181818, 221, 268, 282
28, 600, 0.44, 0.405, 243, 298, 302
28, 650, 0.5, 0.412307692308, 268, 322, 328
28, 700, 0.52, 0.42, 294, 344, 356
28, 750, 0.52, 0.426666666667, 320, 361, 389
28, 800, 0.38, 0.42375, 339, 385, 415
28, 850, 0.6, 0.434117647059, 369, 416, 434
28, 900, 0.48, 0.436666666667, 393, 447, 453
28, 950, 0.52, 0.441052631579, 419, 474, 476
28, 1000, 0.62, 0.45, 450, 497, 503
28, 1050, 0.5, 0.452380952381, 475, 518, 532
28, 1100, 0.56, 0.457272727273, 503, 541, 559
28, 1150, 0.36, 0.453043478261, 521, 560, 590
28, 1200, 0.64, 0.460833333333, 553, 585, 615
28, 1250, 0.46, 0.4608, 576, 607, 643
28, 1300, 0.56, 0.464615384615, 604, 636, 664
28, 1350, 0.48, 0.465185185185, 628, 664, 686
28, 1400, 0.52, 0.467142857143, 654, 691, 709
28, 1450, 0.64, 0.473103448276, 686, 718, 732
28, 1500, 0.52, 0.474666666667, 712, 743, 757
28, 1550, 0.4, 0.472258064516, 732, 769, 781
28, 1600, 0.44, 0.47125, 754, 797, 803
28, 1650, 0.42, 0.469696969697, 775, 817, 833
28, 1700, 0.6, 0.473529411765, 805, 846, 854
28, 1750, 0.54, 0.475428571429, 832, 873, 877
28, 1800, 0.46, 0.475, 855, 896, 904
28, 1850, 0.6, 0.478378378378, 885, 920, 930
28, 1900, 0.52, 0.479473684211, 911, 935, 965
28, 1950, 0.56, 0.481538461538, 939, 960, 990
28, 2000, 0.48, 0.4815, 963, 987, 1013
29, 50, 0.34, 0.34, 17, 19, 31
29, 100, 0.46, 0.4, 40, 39, 61
29, 150, 0.42, 0.406666666667, 61, 63, 87
29, 200, 0.36, 0.395, 79, 84, 116
29, 250, 0.44, 0.404, 101, 110, 140
29, 300, 0.34, 0.393333333333, 118, 141, 159
29, 350, 0.46, 0.402857142857, 141, 166, 184
29, 400, 0.34, 0.395, 158, 193, 207
29, 450, 0.46, 0.402222222222, 181, 220, 230
29, 500, 0.6, 0.422, 211, 248, 252
29, 550, 0.58, 0.436363636364, 240, 270, 280
29, 600, 0.46, 0.438333333333, 263, 291, 309
29, 650, 0.44, 0.438461538462, 285, 318, 332
29, 700, 0.42, 0.437142857143, 306, 343, 357
29, 750, 0.58, 0.446666666667, 335, 365, 385
29, 800, 0.6, 0.45625, 365, 388, 412
29, 850, 0.52, 0.46, 391, 414, 436
29, 900, 0.58, 0.466666666667, 420, 438, 462
29, 950, 0.54, 0.470526315789, 447, 460, 490
29, 1000, 0.36, 0.465, 465, 482, 518
29, 1050, 0.52, 0.467619047619, 491, 509, 541
29, 1100, 0.58, 0.472727272727, 520, 534, 566
29, 1150, 0.54, 0.475652173913, 547, 561, 589
29, 1200, 0.6, 0.480833333333, 577, 587, 613
29, 1250, 0.36, 0.476, 595, 611, 639
29, 1300, 0.44, 0.474615384615, 617, 627, 673
29, 1350, 0.54, 0.477037037037, 644, 656, 694
29, 1400, 0.58, 0.480714285714, 673, 683, 717
29, 1450, 0.38, 0.47724137931, 692, 704, 746
29, 1500, 0.48, 0.477333333333, 716, 722, 778
29, 1550, 0.44, 0.476129032258, 738, 752, 798
29, 1600, 0.42, 0.474375, 759, 776, 824
29, 1650, 0.5, 0.475151515152, 784, 803, 847
29, 1700, 0.5, 0.475882352941, 809, 826, 874
29, 1750, 0.34, 0.472, 826, 849, 901
29, 1800, 0.56, 0.474444444444, 854, 885, 915
29, 1850, 0.56, 0.476756756757, 882, 911, 939
29, 1900, 0.62, 0.480526315789, 913, 936, 964
29, 1950, 0.4, 0.478461538462, 933, 957, 993
29, 2000, 0.54, 0.48, 960, 983, 1017
30, 50, 0.28, 0.28, 14, 28, 22
30, 100, 0.5, 0.39, 39, 53, 47
30, 150, 0.4, 0.393333333333, 59, 76, 74
30, 200, 0.32, 0.375, 75, 103, 97
30, 250, 0.38, 0.376, 94, 127, 123
30, 300, 0.46, 0.39, 117, 146, 154
30, 350, 0.5, 0.405714285714, 142, 171, 179
30, 400, 0.44, 0.41, 164, 198, 202
30, 450, 0.5, 0.42, 189, 222, 228
30, 500, 0.44, 0.422, 211, 244, 256
30, 550, 0.42, 0.421818181818, 232, 263, 287
30, 600, 0.44, 0.423333333333, 254, 288, 312
30, 650, 0.56, 0.433846153846, 282, 312, 338
30, 700, 0.48, 0.437142857143, 306, 337, 363
30, 750, 0.6, 0.448, 336, 359, 391
30, 800, 0.62, 0.45875, 367, 387, 413
30, 850, 0.5, 0.461176470588, 392, 407, 443
30, 900, 0.4, 0.457777777778, 412, 430, 470
30, 950, 0.62, 0.466315789474, 443, 453, 497
30, 1000, 0.54, 0.47, 470, 477, 523
30, 1050, 0.5, 0.471428571429, 495, 497, 553
30, 1100, 0.6, 0.477272727273, 525, 526, 574
30, 1150, 0.5, 0.478260869565, 550, 549, 601
30, 1200, 0.5, 0.479166666667, 575, 576, 624
30, 1250, 0.38, 0.4752, 594, 596, 654
30, 1300, 0.44, 0.473846153846, 616, 617, 683
30, 1350, 0.46, 0.473333333333, 639, 635, 715
30, 1400, 0.44, 0.472142857143, 661, 655, 745
30, 1450, 0.56, 0.475172413793, 689, 682, 768
30, 1500, 0.5, 0.476, 714, 707, 793
30, 1550, 0.4, 0.473548387097, 734, 733, 817
30, 1600, 0.46, 0.473125, 757, 754, 846
30, 1650, 0.48, 0.473333333333, 781, 773, 877
30, 1700, 0.52, 0.474705882353, 807, 802, 898
30, 1750, 0.62, 0.478857142857, 838, 829, 921
30, 1800, 0.36, 0.475555555556, 856, 850, 950
30, 1850, 0.5, 0.476216216216, 881, 876, 974
30, 1900, 0.48, 0.476315789474, 905, 899, 1001
30, 1950, 0.68, 0.481538461538, 939, 926, 1024
30, 2000, 0.54, 0.483, 966, 954, 1046
31, 50, 0.42, 0.42, 21, 30, 20
31, 100, 0.34, 0.38, 38, 53, 47
31, 150, 0.32, 0.36, 54, 80, 70
31, 200, 0.26, 0.335, 67, 105, 95
31, 250, 0.36, 0.34, 85, 134, 116
31, 300, 0.32, 0.336666666667, 101, 162, 138
31, 350, 0.34, 0.337142857143, 118, 185, 165
31, 400, 0.48, 0.355, 142, 205, 195
31, 450, 0.4, 0.36, 162, 231, 219
31, 500, 0.46, 0.37, 185, 261, 239
31, 550, 0.38, 0.370909090909, 204, 280, 270
31, 600, 0.52, 0.383333333333, 230, 301, 299
31, 650, 0.56, 0.396923076923, 258, 324, 326
31, 700, 0.56, 0.408571428571, 286, 350, 350
31, 750, 0.42, 0.409333333333, 307, 370, 380
31, 800, 0.54, 0.4175, 334, 398, 402
31, 850, 0.34, 0.412941176471, 351, 423, 427
31, 900, 0.56, 0.421111111111, 379, 447, 453
31, 950, 0.56, 0.428421052632, 407, 476, 474
31, 1000, 0.4, 0.427, 427, 505, 495
31, 1050, 0.54, 0.432380952381, 454, 529, 521
31, 1100, 0.46, 0.433636363636, 477, 549, 551
31, 1150, 0.56, 0.439130434783, 505, 570, 580
31, 1200, 0.46, 0.44, 528, 601, 599
31, 1250, 0.5, 0.4424, 553, 626, 624
31, 1300, 0.28, 0.436153846154, 567, 653, 647
31, 1350, 0.52, 0.439259259259, 593, 678, 672
31, 1400, 0.52, 0.442142857143, 619, 704, 696
31, 1450, 0.44, 0.442068965517, 641, 729, 721
31, 1500, 0.54, 0.445333333333, 668, 752, 748
31, 1550, 0.54, 0.448387096774, 695, 779, 771
31, 1600, 0.6, 0.453125, 725, 803, 797
31, 1650, 0.4, 0.451515151515, 745, 829, 821
31, 1700, 0.42, 0.450588235294, 766, 856, 844
31, 1750, 0.46, 0.450857142857, 789, 883, 867
31, 1800, 0.62, 0.455555555556, 820, 908, 892
31, 1850, 0.48, 0.456216216216, 844, 931, 919
31, 1900, 0.56, 0.458947368421, 872, 956, 944
31, 1950, 0.58, 0.462051282051, 901, 983, 967
31, 2000, 0.44, 0.4615, 923, 1006, 994
32, 50, 0.36, 0.36, 18, 20, 30
32, 100, 0.42, 0.39, 39, 49, 51
32, 150, 0.38, 0.386666666667, 58, 75, 75
32, 200, 0.44, 0.4, 80, 97, 103
32, 250, 0.36, 0.392, 98, 117, 133
32, 300, 0.38, 0.39, 117, 138, 162
32, 350, 0.24, 0.368571428571, 129, 161, 189
32, 400, 0.4, 0.3725, 149, 191, 209
32, 450, 0.54, 0.391111111111, 176, 221, 229
32, 500, 0.52, 0.404, 202, 248, 252
32, 550, 0.58, 0.42, 231, 276, 274
32, 600, 0.46, 0.423333333333, 254, 298, 302
32, 650, 0.6, 0.436923076923, 284, 326, 324
32, 700, 0.56, 0.445714285714, 312, 350, 350
32, 750, 0.4, 0.442666666667, 332, 376, 374
32, 800, 0.46, 0.44375, 355, 397, 403
32, 850, 0.52, 0.448235294118, 381, 426, 424
32, 900, 0.52, 0.452222222222, 407, 446, 454
32, 950, 0.36, 0.447368421053, 425, 468, 482
32, 1000, 0.38, 0.444, 444, 490, 510
32, 1050, 0.56, 0.449523809524, 472, 519, 531
32, 1100, 0.56, 0.454545454545, 500, 549, 551
32, 1150, 0.52, 0.457391304348, 526, 567, 583
32, 1200, 0.58, 0.4625, 555, 588, 612
32, 1250, 0.52, 0.4648, 581, 612, 638
32, 1300, 0.5, 0.466153846154, 606, 638, 662
32, 1350, 0.5, 0.467407407407, 631, 660, 690
32, 1400, 0.56, 0.470714285714, 659, 687, 713
32, 1450, 0.58, 0.474482758621, 688, 713, 737
32, 1500, 0.5, 0.475333333333, 713, 742, 758
32, 1550, 0.52, 0.476774193548, 739, 770, 780
32, 1600, 0.62, 0.48125, 770, 796, 804
32, 1650, 0.48, 0.481212121212, 794, 814, 836
32, 1700, 0.54, 0.482941176471, 821, 840, 860
32, 1750, 0.56, 0.485142857143, 849, 867, 883
32, 1800, 0.48, 0.485, 873, 893, 907
32, 1850, 0.52, 0.485945945946, 899, 916, 934
32, 1900, 0.32, 0.481578947368, 915, 943, 957
32, 1950, 0.62, 0.485128205128, 946, 969, 981
32, 2000, 0.44, 0.484, 968, 990, 1010
33, 50, 0.52, 0.52, 26, 26, 24
33, 100, 0.34, 0.43, 43, 54, 46
33, 150, 0.44, 0.433333333333, 65, 79, 71
33, 200, 0.34, 0.41, 82, 100, 100
33, 250, 0.48, 0.424, 106, 127, 123
33, 300, 0.5, 0.436666666667, 131, 156, 144
33, 350, 0.46, 0.44, 154, 180, 170
33, 400, 0.42, 0.4375, 175, 206, 194
33, 450, 0.48, 0.442222222222, 199, 235, 215
33, 500, 0.48, 0.446, 223, 257, 243
33, 550, 0.54, 0.454545454545, 250, 285, 265
33, 600, 0.46, 0.455, 273, 310, 290
33, 650, 0.52, 0.46, 299, 333, 317
33, 700, 0.54, 0.465714285714, 326, 360, 340
33, 750, 0.52, 0.469333333333, 352, 385, 365
33, 800, 0.56, 0.475, 380, 413, 387
33, 850, 0.44, 0.472941176471, 402, 437, 413
33, 900, 0.36, 0.466666666667, 420, 460, 440
33, 950, 0.52, 0.469473684211, 446, 485, 465
33, 1000, 0.58, 0.475, 475, 510, 490
33, 1050, 0.54, 0.478095238095, 502, 538, 512
33, 1100, 0.4, 0.474545454545, 522, 557, 543
33, 1150, 0.4, 0.471304347826, 542, 583, 567
33, 1200, 0.52, 0.473333333333, 568, 611, 589
33, 1250, 0.58, 0.4776, 597, 638, 612
33, 1300, 0.44, 0.476153846154, 619, 659, 641
33, 1350, 0.5, 0.477037037037, 644, 684, 666
33, 1400, 0.5, 0.477857142857, 669, 713, 687
33, 1450, 0.4, 0.475172413793, 689, 732, 718
33, 1500, 0.46, 0.474666666667, 712, 755, 745
33, 1550, 0.48, 0.474838709677, 736, 782, 768
33, 1600, 0.5, 0.475625, 761, 807, 793
33, 1650, 0.46, 0.475151515152, 784, 840, 810
33, 1700, 0.58, 0.478235294118, 813, 870, 830
33, 1750, 0.56, 0.480571428571, 841, 891, 859
33, 1800, 0.42, 0.478888888889, 862, 914, 886
33, 1850, 0.44, 0.477837837838, 884, 944, 906
33, 1900, 0.48, 0.477894736842, 908, 975, 925
33, 1950, 0.44, 0.476923076923, 930, 998, 952
33, 2000, 0.4, 0.475, 950, 1025, 975
34, 50, 0.36, 0.36, 18, 23, 27
34, 100, 0.32, 0.34, 34, 51, 49
34, 150, 0.3, 0.326666666667, 49, 73, 77
34, 200, 0.5, 0.37, 74, 99, 101
34, 250, 0.38, 0.372, 93, 130, 120
34, 300, 0.3, 0.36, 108, 158, 142
34, 350, 0.56, 0.388571428571, 136, 184, 166
34, 400, 0.34, 0.3825, 153, 208, 192
34, 450, 0.5, 0.395555555556, 178, 226, 224
34, 500, 0.56, 0.412, 206, 246, 254
34, 550, 0.48, 0.418181818182, 230, 267, 283
34, 600, 0.42, 0.418333333333, 251, 290, 310
34, 650, 0.38, 0.415384615385, 270, 323, 327
34, 700, 0.52, 0.422857142857, 296, 347, 353
34, 750, 0.5, 0.428, 321, 372, 378
34, 800, 0.42, 0.4275, 342, 396, 404
34, 850, 0.4, 0.425882352941, 362, 424, 426
34, 900, 0.44, 0.426666666667, 384, 447, 453
34, 950, 0.52, 0.431578947368, 410, 470, 480
34, 1000, 0.44, 0.432, 432, 497, 503
34, 1050, 0.42, 0.431428571429, 453, 526, 524
34, 1100, 0.64, 0.440909090909, 485, 552, 548
34, 1150, 0.6, 0.447826086957, 515, 575, 575
34, 1200, 0.56, 0.4525, 543, 601, 599
34, 1250, 0.54, 0.456, 570, 623, 627
34, 1300, 0.44, 0.455384615385, 592, 652, 648
34, 1350, 0.5, 0.457037037037, 617, 675, 675
34, 1400, 0.56, 0.460714285714, 645, 702, 698
34, 1450, 0.42, 0.459310344828, 666, 731, 719
34, 1500, 0.38, 0.456666666667, 685, 754, 746
34, 1550, 0.46, 0.456774193548, 708, 779, 771
34, 1600, 0.48, 0.4575, 732, 805, 795
34, 1650, 0.58, 0.461212121212, 761, 834, 816
34, 1700, 0.62, 0.465882352941, 792, 864, 836
34, 1750, 0.64, 0.470857142857, 824, 889, 861
34, 1800, 0.4, 0.468888888889, 844, 913, 887
34, 1850, 0.6, 0.472432432432, 874, 941, 909
34, 1900, 0.6, 0.475789473684, 904, 969, 931
34, 1950, 0.66, 0.480512820513, 937, 995, 955
34, 2000, 0.46, 0.48, 960, 1018, 982
35, 50, 0.52, 0.52, 26, 25, 25
35, 100, 0.44, 0.48, 48, 52, 48
35, 150, 0.36, 0.44, 66, 72, 78
35, 200, 0.44, 0.44, 88, 97, 103
35, 250, 0.3, 0.412, 103, 121, 129
35, 300, 0.32, 0.396666666667, 119, 146, 154
35, 350, 0.4, 0.397142857143, 139, 171, 179
35, 400, 0.38, 0.395, 158, 200, 200
35, 450, 0.46, 0.402222222222, 181, 226, 224
35, 500, 0.44, 0.406, 203, 252, 248
35, 550, 0.52, 0.416363636364, 229, 272, 278
35, 600, 0.48, 0.421666666667, 253, 299, 301
35, 650, 0.6, 0.435384615385, 283, 328, 322
35, 700, 0.48, 0.438571428571, 307, 352, 348
35, 750, 0.5, 0.442666666667, 332, 376, 374
35, 800, 0.44, 0.4425, 354, 406, 394
35, 850, 0.52, 0.447058823529, 380, 430, 420
35, 900, 0.5, 0.45, 405, 451, 449
35, 950, 0.54, 0.454736842105, 432, 477, 473
35, 1000, 0.46, 0.455, 455, 504, 496
35, 1050, 0.5, 0.457142857143, 480, 534, 516
35, 1100, 0.54, 0.460909090909, 507, 558, 542
35, 1150, 0.56, 0.465217391304, 535, 582, 568
35, 1200, 0.38, 0.461666666667, 554, 605, 595
35, 1250, 0.46, 0.4616, 577, 631, 619
35, 1300, 0.38, 0.458461538462, 596, 656, 644
35, 1350, 0.46, 0.458518518519, 619, 679, 671
35, 1400, 0.54, 0.461428571429, 646, 707, 693
35, 1450, 0.5, 0.46275862069, 671, 729, 721
35, 1500, 0.54, 0.465333333333, 698, 752, 748
35, 1550, 0.48, 0.465806451613, 722, 779, 771
35, 1600, 0.52, 0.4675, 748, 806, 794
35, 1650, 0.44, 0.466666666667, 770, 824, 826
35, 1700, 0.6, 0.470588235294, 800, 847, 853
35, 1750, 0.4, 0.468571428571, 820, 865, 885
35, 1800, 0.6, 0.472222222222, 850, 889, 911
35, 1850, 0.5, 0.472972972973, 875, 910, 940
35, 1900, 0.54, 0.474736842105, 902, 936, 964
35, 1950, 0.52, 0.475897435897, 928, 960, 990
35, 2000, 0.28, 0.471, 942, 984, 1016
36, 50, 0.36, 0.36, 18, 25, 25
36, 100, 0.4, 0.38, 38, 54, 46
36, 150, 0.38, 0.38, 57, 74, 76
36, 200, 0.36, 0.375, 75, 105, 95
36, 250, 0.46, 0.392, 98, 122, 128
36, 300, 0.46, 0.403333333333, 121, 148, 152
36, 350, 0.34, 0.394285714286, 138, 177, 173
36, 400, 0.58, 0.4175, 167, 194, 206
36, 450, 0.48, 0.424444444444, 191, 222, 228
36, 500, 0.44, 0.426, 213, 240, 260
36, 550, 0.5, 0.432727272727, 238, 267, 283
36, 600, 0.58, 0.445, 267, 298, 302
36, 650, 0.44, 0.444615384615, 289, 314, 336
36, 700, 0.46, 0.445714285714, 312, 336, 364
36, 750, 0.52, 0.450666666667, 338, 361, 389
36, 800, 0.48, 0.4525, 362, 383, 417
36, 850, 0.56, 0.458823529412, 390, 412, 438
36, 900, 0.46, 0.458888888889, 413, 442, 458
36, 950, 0.52, 0.462105263158, 439, 471, 479
36, 1000, 0.48, 0.463, 463, 495, 505
36, 1050, 0.42, 0.460952380952, 484, 520, 530
36, 1100, 0.56, 0.465454545455, 512, 547, 553
36, 1150, 0.42, 0.46347826087, 533, 570, 580
36, 1200, 0.52, 0.465833333333, 559, 591, 609
36, 1250, 0.5, 0.4672, 584, 616, 634
36, 1300, 0.56, 0.470769230769, 612, 642, 658
36, 1350, 0.42, 0.468888888889, 633, 669, 681
36, 1400, 0.42, 0.467142857143, 654, 695, 705
36, 1450, 0.56, 0.470344827586, 682, 720, 730
36, 1500, 0.44, 0.469333333333, 704, 742, 758
36, 1550, 0.54, 0.471612903226, 731, 764, 786
36, 1600, 0.5, 0.4725, 756, 794, 806
36, 1650, 0.46, 0.472121212121, 779, 821, 829
36, 1700, 0.52, 0.473529411765, 805, 847, 853
36, 1750, 0.46, 0.473142857143, 828, 873, 877
36, 1800, 0.54, 0.475, 855, 895, 905
36, 1850, 0.4, 0.472972972973, 875, 920, 930
36, 1900, 0.5, 0.473684210526, 900, 940, 960
36, 1950, 0.36, 0.470769230769, 918, 956, 994
36, 2000, 0.56, 0.473, 946, 983, 1017
37, 50, 0.44, 0.44, 22, 19, 31
37, 100, 0.44, 0.44, 44, 44, 56
37, 150, 0.42, 0.433333333333, 65, 66, 84
37, 200, 0.44, 0.435, 87, 85, 115
37, 250, 0.36, 0.42, 105, 107, 143
37, 300, 0.4, 0.416666666667, 125, 136, 164
37, 350, 0.5, 0.428571428571, 150, 162, 188
37, 400, 0.3, 0.4125, 165, 186, 214
37, 450, 0.44, 0.415555555556, 187, 215, 235
37, 500, 0.62, 0.436, 218, 241, 259
37, 550, 0.5, 0.441818181818, 243, 269, 281
37, 600, 0.48, 0.445, 267, 287, 313
37, 650, 0.64, 0.46, 299, 314, 336
37, 700, 0.44, 0.458571428571, 321, 341, 359
37, 750, 0.58, 0.466666666667, 350, 368, 382
37, 800, 0.42, 0.46375, 371, 392, 408
37, 850, 0.62, 0.472941176471, 402, 419, 431
37, 900, 0.5, 0.474444444444, 427, 442, 458
37, 950, 0.6, 0.481052631579, 457, 472, 478
37, 1000, 0.48, 0.481, 481, 498, 502
37, 1050, 0.56, 0.484761904762, 509, 521, 529
37, 1100, 0.56, 0.488181818182, 537, 544, 556
37, 1150, 0.46, 0.486956521739, 560, 574, 576
37, 1200, 0.44, 0.485, 582, 597, 603
37, 1250, 0.48, 0.4848, 606, 617, 633
37, 1300, 0.36, 0.48, 624, 644, 656
37, 1350, 0.54, 0.482222222222, 651, 673, 677
37, 1400, 0.46, 0.481428571429, 674, 695, 705
37, 1450, 0.52, 0.48275862069, 700, 722, 728
37, 1500, 0.46, 0.482, 723, 746, 754
37, 1550, 0.34, 0.477419354839, 740, 778, 772
37, 1600, 0.42, 0.475625, 761, 806, 794
37, 1650, 0.52, 0.47696969697, 787, 835, 815
37, 1700, 0.44, 0.475882352941, 809, 862, 838
37, 1750, 0.46, 0.475428571429, 832, 885, 865
37, 1800, 0.56, 0.477777777778, 860, 912, 888
37, 1850, 0.5, 0.478378378378, 885, 938, 912
37, 1900, 0.52, 0.479473684211, 911, 959, 941
37, 1950, 0.42, 0.477948717949, 932, 987, 963
37, 2000, 0.48, 0.478, 956, 1012, 988
38, 50, 0.28, 0.28, 14, 25, 25
38, 100, 0.38, 0.33, 33, 54, 46
38, 150, 0.38, 0.346666666667, 52, 83, 67
38, 200, 0.36, 0.35, 70, 111, 89
38, 250, 0.36, 0.352, 88, 134, 116
38, 300, 0.42, 0.363333333333, 109, 160, 140
38, 350, 0.4, 0.368571428571, 129, 184, 166
38, 400, 0.36, 0.3675, 147, 207, 193
38, 450, 0.48, 0.38, 171, 234, 216
38, 500, 0.54, 0.396, 198, 259, 241
38, 550, 0.56, 0.410909090909, 226, 287, 263
38, 600, 0.7, 0.435, 261, 310, 290
38, 650, 0.52, 0.441538461538, 287, 332, 318
38, 700, 0.52, 0.447142857143, 313, 354, 346
38, 750, 0.66, 0.461333333333, 346, 380, 370
38, 800, 0.52, 0.465, 372, 408, 392
38, 850, 0.46, 0.464705882353, 395, 436, 414
38, 900, 0.5, 0.466666666667, 420, 457, 443
38, 950, 0.48, 0.467368421053, 444, 477, 473
38, 1000, 0.56, 0.472, 472, 504, 496
38, 1050, 0.52, 0.474285714286, 498, 538, 512
38, 1100, 0.5, 0.475454545455, 523, 558, 542
38, 1150, 0.6, 0.480869565217, 553, 586, 564
38, 1200, 0.54, 0.483333333333, 580, 616, 584
38, 1250, 0.48, 0.4832, 604, 637, 613
38, 1300, 0.52, 0.484615384615, 630, 662, 638
38, 1350, 0.44, 0.482962962963, 652, 688, 662
38, 1400, 0.44, 0.481428571429, 674, 710, 690
38, 1450, 0.52, 0.48275862069, 700, 733, 717
38, 1500, 0.48, 0.482666666667, 724, 752, 748
38, 1550, 0.54, 0.484516129032, 751, 774, 776
38, 1600, 0.56, 0.486875, 779, 801, 799
38, 1650, 0.6, 0.490303030303, 809, 825, 825
38, 1700, 0.58, 0.492941176471, 838, 844, 856
38, 1750, 0.46, 0.492, 861, 864, 886
38, 1800, 0.46, 0.491111111111, 884, 895, 905
38, 1850, 0.52, 0.491891891892, 910, 918, 932
38, 1900, 0.5, 0.492105263158, 935, 946, 954
38, 1950, 0.48, 0.491794871795, 959, 974, 976
38, 2000, 0.44, 0.4905, 981, 1001, 999
39, 50, 0.36, 0.36, 18, 29, 21
39, 100, 0.46, 0.41, 41, 55, 45
39, 150, 0.32, 0.38, 57, 80, 70
39, 200, 0.38, 0.38, 76, 100, 100
39, 250, 0.44, 0.392, 98, 126, 124
39, 300, 0.4, 0.393333333333, 118, 151, 149
39, 350, 0.32, 0.382857142857, 134, 178, 172
39, 400, 0.38, 0.3825, 153, 204, 196
39, 450, 0.58, 0.404444444444, 182, 228, 222
39, 500, 0.58, 0.422, 211, 250, 250
39, 550, 0.54, 0.432727272727, 238, 280, 270
39, 600, 0.62, 0.448333333333, 269, 307, 293
39, 650, 0.38, 0.443076923077, 288, 331, 319
39, 700, 0.6, 0.454285714286, 318, 360, 340
39, 750, 0.42, 0.452, 339, 383, 367
39, 800, 0.54, 0.4575, 366, 406, 394
39, 850, 0.48, 0.458823529412, 390, 434, 416
39, 900, 0.6, 0.466666666667, 420, 454, 446
39, 950, 0.58, 0.472631578947, 449, 477, 473
39, 1000, 0.54, 0.476, 476, 504, 496
39, 1050, 0.46, 0.475238095238, 499, 531, 519
39, 1100, 0.5, 0.476363636364, 524, 561, 539
39, 1150, 0.44, 0.474782608696, 546, 584, 566
39, 1200, 0.62, 0.480833333333, 577, 608, 592
39, 1250, 0.5, 0.4816, 602, 635, 615
39, 1300, 0.44, 0.48, 624, 665, 635
39, 1350, 0.54, 0.482222222222, 651, 692, 658
39, 1400, 0.48, 0.482142857143, 675, 717, 683
39, 1450, 0.48, 0.482068965517, 699, 746, 704
39, 1500, 0.48, 0.482, 723, 773, 727
39, 1550, 0.42, 0.48, 744, 800, 750
39, 1600, 0.58, 0.483125, 773, 826, 774
39, 1650, 0.52, 0.484242424242, 799, 850, 800
39, 1700, 0.58, 0.487058823529, 828, 874, 826
39, 1750, 0.46, 0.486285714286, 851, 901, 849
39, 1800, 0.34, 0.482222222222, 868, 923, 877
39, 1850, 0.46, 0.481621621622, 891, 948, 902
39, 1900, 0.46, 0.481052631579, 914, 969, 931
39, 1950, 0.44, 0.48, 936, 996, 954
39, 2000, 0.6, 0.483, 966, 1019, 981
40, 50, 0.36, 0.36, 18, 33, 17
40, 100, 0.36, 0.36, 36, 55, 45
40, 150, 0.3, 0.34, 51, 76, 74
40, 200, 0.32, 0.335, 67, 105, 95
40, 250, 0.36, 0.34, 85, 127, 123
40, 300, 0.22, 0.32, 96, 148, 152
40, 350, 0.36, 0.325714285714, 114, 169, 181
40, 400, 0.42, 0.3375, 135, 196, 204
40, 450, 0.58, 0.364444444444, 164, 226, 224
40, 500, 0.48, 0.376, 188, 256, 244
40, 550, 0.42, 0.38, 209, 278, 272
40, 600, 0.52, 0.391666666667, 235, 304, 296
40, 650, 0.56, 0.404615384615, 263, 328, 322
40, 700, 0.58, 0.417142857143, 292, 357, 343
40, 750, 0.46, 0.42, 315, 381, 369
40, 800, 0.54, 0.4275, 342, 397, 403
40, 850, 0.54, 0.434117647059, 369, 431, 419
40, 900, 0.5, 0.437777777778, 394, 460, 440
40, 950, 0.7, 0.451578947368, 429, 483, 467
40, 1000, 0.6, 0.459, 459, 508, 492
40, 1050, 0.54, 0.462857142857, 486, 530, 520
40, 1100, 0.5, 0.464545454545, 511, 556, 544
40, 1150, 0.52, 0.466956521739, 537, 583, 567
40, 1200, 0.56, 0.470833333333, 565, 611, 589
40, 1250, 0.48, 0.4712, 589, 639, 611
40, 1300, 0.52, 0.473076923077, 615, 667, 633
40, 1350, 0.52, 0.474814814815, 641, 694, 656
40, 1400, 0.46, 0.474285714286, 664, 719, 681
40, 1450, 0.5, 0.475172413793, 689, 737, 713
40, 1500, 0.48, 0.475333333333, 713, 751, 749
40, 1550, 0.58, 0.478709677419, 742, 775, 775
40, 1600, 0.58, 0.481875, 771, 797, 803
40, 1650, 0.56, 0.484242424242, 799, 818, 832
40, 1700, 0.5, 0.484705882353, 824, 847, 853
40, 1750, 0.44, 0.483428571429, 846, 869, 881
40, 1800, 0.62, 0.487222222222, 877, 897, 903
40, 1850, 0.46, 0.486486486486, 900, 919, 931
40, 1900, 0.42, 0.484736842105, 921, 948, 952
40, 1950, 0.48, 0.484615384615, 945, 968, 982
40, 2000, 0.48, 0.4845, 969, 993, 1007
41, 50, 0.32, 0.32, 16, 28, 22
41, 100, 0.34, 0.33, 33, 57, 43
41, 150, 0.28, 0.313333333333, 47, 84, 66
41, 200, 0.46, 0.35, 70, 106, 94
41, 250, 0.32, 0.344, 86, 133, 117
41, 300, 0.36, 0.346666666667, 104, 157, 143
41, 350, 0.2, 0.325714285714, 114, 185, 165
41, 400, 0.38, 0.3325, 133, 207, 193
41, 450, 0.38, 0.337777777778, 152, 227, 223
41, 500, 0.52, 0.356, 178, 254, 246
41, 550, 0.44, 0.363636363636, 200, 277, 273
41, 600, 0.54, 0.378333333333, 227, 307, 293
41, 650, 0.4, 0.38, 247, 335, 315
41, 700, 0.38, 0.38, 266, 360, 340
41, 750, 0.54, 0.390666666667, 293, 390, 360
41, 800, 0.4, 0.39125, 313, 414, 386
41, 850, 0.48, 0.396470588235, 337, 440, 410
41, 900, 0.54, 0.404444444444, 364, 466, 434
41, 950, 0.56, 0.412631578947, 392, 486, 464
41, 1000, 0.6, 0.422, 422, 505, 495
41, 1050, 0.56, 0.428571428571, 450, 532, 518
41, 1100, 0.6, 0.436363636364, 480, 555, 545
41, 1150, 0.56, 0.441739130435, 508, 576, 574
41, 1200, 0.54, 0.445833333333, 535, 602, 598
41, 1250, 0.44, 0.4456, 557, 629, 621
41, 1300, 0.5, 0.447692307692, 582, 653, 647
41, 1350, 0.42, 0.446666666667, 603, 675, 675
41, 1400, 0.56, 0.450714285714, 631, 697, 703
41, 1450, 0.42, 0.449655172414, 652, 719, 731
41, 1500, 0.62, 0.455333333333, 683, 748, 752
41, 1550, 0.32, 0.450967741935, 699, 776, 774
41, 1600, 0.56, 0.454375, 727, 804, 796
41, 1650, 0.56, 0.457575757576, 755, 829, 821
41, 1700, 0.5, 0.458823529412, 780, 855, 845
41, 1750, 0.42, 0.457714285714, 801, 881, 869
41, 1800, 0.6, 0.461666666667, 831, 910, 890
41, 1850, 0.6, 0.465405405405, 861, 938, 912
41, 1900, 0.46, 0.465263157895, 884, 961, 939
41, 1950, 0.58, 0.468205128205, 913, 979, 971
41, 2000, 0.58, 0.471, 942, 1006, 994
42, 50, 0.5, 0.5, 25, 25, 25
42, 100, 0.3, 0.4, 40, 50, 50
42, 150, 0.42, 0.406666666667, 61, 70, 80
42, 200, 0.4, 0.405, 81, 88, 112
42, 250, 0.48, 0.42, 105, 107, 143
42, 300, 0.46, 0.426666666667, 128, 133, 167
42, 350, 0.26, 0.402857142857, 141, 154, 196
42, 400, 0.36, 0.3975, 159, 183, 217
42, 450, 0.46, 0.404444444444, 182, 206, 244
42, 500, 0.52, 0.416, 208, 227, 273
42, 550, 0.6, 0.432727272727, 238, 249, 301
42, 600, 0.52, 0.44, 264, 269, 331
42, 650, 0.46, 0.441538461538, 287, 294, 356
42, 700, 0.48, 0.444285714286, 311, 323, 377
42, 750, 0.56, 0.452, 339, 353, 397
42, 800, 0.52, 0.45625, 365, 378, 422
42, 850, 0.62, 0.465882352941, 396, 407, 443
42, 900, 0.4, 0.462222222222, 416, 425, 475
42, 950, 0.5, 0.464210526316, 441, 454, 496
42, 1000, 0.44, 0.463, 463, 482, 518
42, 1050, 0.54, 0.466666666667, 490, 513, 537
42, 1100, 0.46, 0.466363636364, 513, 536, 564
42, 1150, 0.52, 0.468695652174, 539, 562, 588
42, 1200, 0.5, 0.47, 564, 590, 610
42, 1250, 0.52, 0.472, 590, 616, 634
42, 1300, 0.42, 0.47, 611, 640, 660
42, 1350, 0.56, 0.473333333333, 639, 667, 683
42, 1400, 0.5, 0.474285714286, 664, 695, 705
42, 1450, 0.52, 0.475862068966, 690, 723, 727
42, 1500, 0.42, 0.474, 711, 749, 751
42, 1550, 0.58, 0.477419354839, 740, 777, 773
42, 1600, 0.46, 0.476875, 763, 797, 803
42, 1650, 0.54, 0.478787878788, 790, 827, 823
42, 1700, 0.42, 0.477058823529, 811, 854, 846
42, 1750, 0.52, 0.478285714286, 837, 880, 870
42, 1800, 0.44, 0.477222222222, 859, 909, 891
42, 1850, 0.52, 0.478378378378, 885, 935, 915
42, 1900, 0.56, 0.480526315789, 913, 959, 941
42, 1950, 0.34, 0.476923076923, 930, 978, 972
42, 2000, 0.44, 0.476, 952, 1002, 998
43, 50, 0.24, 0.24, 12, 29, 21
43, 100, 0.4, 0.32, 32, 57, 43
43, 150, 0.3, 0.313333333333, 47, 83, 67
43, 200, 0.38, 0.33, 66, 110, 90
43, 250, 0.32, 0.328, 82, 141, 109
43, 300, 0.34, 0.33, 99, 165, 135
43, 350, 0.5, 0.354285714286, 124, 194, 156
43, 400, 0.46, 0.3675, 147, 221, 179
43, 450, 0.52, 0.384444444444, 173, 237, 213
43, 500, 0.46, 0.392, 196, 260, 240
43, 550, 0.42, 0.394545454545, 217, 277, 273
43, 600, 0.6, 0.411666666667, 247, 303, 297
43, 650, 0.54, 0.421538461538, 274, 328, 322
43, 700, 0.48, 0.425714285714, 298, 353, 347
43, 750, 0.46, 0.428, 321, 379, 371
43, 800, 0.44, 0.42875, 343, 398, 402
43, 850, 0.56, 0.436470588235, 371, 427, 423
43, 900, 0.4, 0.434444444444, 391, 450, 450
43, 950, 0.56, 0.441052631579, 419, 477, 473
43, 1000, 0.38, 0.438, 438, 501, 499
43, 1050, 0.5, 0.440952380952, 463, 525, 525
43, 1100, 0.5, 0.443636363636, 488, 548, 552
43, 1150, 0.5, 0.446086956522, 513, 573, 577
43, 1200, 0.36, 0.4425, 531, 599, 601
43, 1250, 0.6, 0.4488, 561, 620, 630
43, 1300, 0.5, 0.450769230769, 586, 642, 658
43, 1350, 0.42, 0.44962962963, 607, 665, 685
43, 1400, 0.5, 0.451428571429, 632, 692, 708
43, 1450, 0.56, 0.455172413793, 660, 715, 735
43, 1500, 0.58, 0.459333333333, 689, 744, 756
43, 1550, 0.5, 0.46064516129, 714, 764, 786
43, 1600, 0.5, 0.461875, 739, 786, 814
43, 1650, 0.54, 0.464242424242, 766, 814, 836
43, 1700, 0.48, 0.464705882353, 790, 842, 858
43, 1750, 0.52, 0.466285714286, 816, 868, 882
43, 1800, 0.52, 0.467777777778, 842, 885, 915
43, 1850, 0.62, 0.471891891892, 873, 913, 937
43, 1900, 0.36, 0.468947368421, 891, 933, 967
43, 1950, 0.5, 0.469743589744, 916, 959, 991
43, 2000, 0.44, 0.469, 938, 986, 1014
44, 50, 0.34, 0.34, 17, 24, 26
44, 100, 0.4, 0.37, 37, 54, 46
44, 150, 0.4, 0.38, 57, 81, 69
44, 200, 0.36, 0.375, 75, 106, 94
44, 250, 0.44, 0.388, 97, 136, 114
44, 300, 0.5, 0.406666666667, 122, 157, 143
44, 350, 0.26, 0.385714285714, 135, 180, 170
44, 400, 0.38, 0.385, 154, 200, 200
44, 450, 0.48, 0.395555555556, 178, 226, 224
44, 500, 0.52, 0.408, 204, 251, 249
44, 550, 0.46, 0.412727272727, 227, 274, 276
44, 600, 0.46, 0.416666666667, 250, 295, 305
44, 650, 0.56, 0.427692307692, 278, 320, 330
44, 700, 0.58, 0.438571428571, 307, 350, 350
44, 750, 0.36, 0.433333333333, 325, 373, 377
44, 800, 0.46, 0.435, 348, 397, 403
44, 850, 0.58, 0.443529411765, 377, 427, 423
44, 900, 0.48, 0.445555555556, 401, 452, 448
44, 950, 0.54, 0.450526315789, 428, 476, 474
44, 1000, 0.42, 0.449, 449, 500, 500
44, 1050, 0.66, 0.459047619048, 482, 528, 522
44, 1100, 0.54, 0.462727272727, 509, 553, 547
44, 1150, 0.36, 0.458260869565, 527, 580, 570
44, 1200, 0.52, 0.460833333333, 553, 607, 593
44, 1250, 0.3, 0.4544, 568, 631, 619
44, 1300, 0.54, 0.457692307692, 595, 655, 645
44, 1350, 0.54, 0.460740740741, 622, 685, 665
44, 1400, 0.36, 0.457142857143, 640, 709, 691
44, 1450, 0.44, 0.456551724138, 662, 731, 719
44, 1500, 0.54, 0.459333333333, 689, 762, 738
44, 1550, 0.52, 0.461290322581, 715, 790, 760
44, 1600, 0.5, 0.4625, 740, 809, 791
44, 1650, 0.42, 0.461212121212, 761, 833, 817
44, 1700, 0.62, 0.465882352941, 792, 858, 842
44, 1750, 0.58, 0.469142857143, 821, 883, 867
44, 1800, 0.5, 0.47, 846, 905, 895
44, 1850, 0.56, 0.472432432432, 874, 933, 917
44, 1900, 0.44, 0.471578947368, 896, 962, 938
44, 1950, 0.54, 0.473333333333, 923, 991, 959
44, 2000, 0.34, 0.47, 940, 1015, 985
45, 50, 0.46, 0.46, 23, 17, 33
45, 100, 0.44, 0.45, 45, 38, 62
45, 150, 0.36, 0.42, 63, 63, 87
45, 200, 0.44, 0.425, 85, 85, 115
45, 250, 0.3, 0.4, 100, 108, 142
45, 300, 0.38, 0.396666666667, 119, 131, 169
45, 350, 0.32, 0.385714285714, 135, 158, 192
45, 400, 0.34, 0.38, 152, 185, 215
45, 450, 0.38, 0.38, 171, 213, 237
45, 500, 0.44, 0.386, 193, 233, 267
45, 550, 0.5, 0.396363636364, 218, 255, 295
45, 600, 0.42, 0.398333333333, 239, 280, 320
45, 650, 0.52, 0.407692307692, 265, 302, 348
45, 700, 0.38, 0.405714285714, 284, 326, 374
45, 750, 0.44, 0.408, 306, 345, 405
45, 800, 0.52, 0.415, 332, 363, 437
45, 850, 0.5, 0.42, 357, 386, 464
45, 900, 0.28, 0.412222222222, 371, 404, 496
45, 950, 0.5, 0.416842105263, 396, 431, 519
45, 1000, 0.52, 0.422, 422, 448, 552
45, 1050, 0.4, 0.420952380952, 442, 470, 580
45, 1100, 0.54, 0.426363636364, 469, 495, 605
45, 1150, 0.6, 0.433913043478, 499, 525, 625
45, 1200, 0.44, 0.434166666667, 521, 545, 655
45, 1250, 0.62, 0.4416, 552, 577, 673
45, 1300, 0.52, 0.444615384615, 578, 602, 698
45, 1350, 0.46, 0.445185185185, 601, 625, 725
45, 1400, 0.72, 0.455, 637, 653, 747
45, 1450, 0.4, 0.453103448276, 657, 677, 773
45, 1500, 0.58, 0.457333333333, 686, 701, 799
45, 1550, 0.5, 0.458709677419, 711, 729, 821
45, 1600, 0.58, 0.4625, 740, 748, 852
45, 1650, 0.5, 0.463636363636, 765, 774, 876
45, 1700, 0.5, 0.464705882353, 790, 797, 903
45, 1750, 0.52, 0.466285714286, 816, 825, 925
45, 1800, 0.54, 0.468333333333, 843, 851, 949
45, 1850, 0.52, 0.46972972973, 869, 875, 975
45, 1900, 0.54, 0.471578947368, 896, 901, 999
45, 1950, 0.48, 0.471794871795, 920, 929, 1021
45, 2000, 0.38, 0.4695, 939, 951, 1049
46, 50, 0.48, 0.48, 24, 25, 25
46, 100, 0.32, 0.4, 40, 47, 53
46, 150, 0.44, 0.413333333333, 62, 73, 77
46, 200, 0.16, 0.35, 70, 101, 99
46, 250, 0.3, 0.34, 85, 129, 121
46, 300, 0.42, 0.353333333333, 106, 151, 149
46, 350, 0.32, 0.348571428571, 122, 178, 172
46, 400, 0.4, 0.355, 142, 205, 195
46, 450, 0.52, 0.373333333333, 168, 230, 220
46, 500, 0.54, 0.39, 195, 250, 250
46, 550, 0.46, 0.396363636364, 218, 277, 273
46, 600, 0.54, 0.408333333333, 245, 304, 296
46, 650, 0.54, 0.418461538462, 272, 329, 321
46, 700, 0.48, 0.422857142857, 296, 349, 351
46, 750, 0.38, 0.42, 315, 373, 377
46, 800, 0.46, 0.4225, 338, 397, 403
46, 850, 0.42, 0.422352941176, 359, 421, 429
46, 900, 0.38, 0.42, 378, 444, 456
46, 950, 0.54, 0.426315789474, 405, 461, 489
46, 1000, 0.48, 0.429, 429, 486, 514
46, 1050, 0.48, 0.431428571429, 453, 510, 540
46, 1100, 0.52, 0.435454545455, 479, 537, 563
46, 1150, 0.5, 0.438260869565, 504, 561, 589
46, 1200, 0.58, 0.444166666667, 533, 589, 611
46, 1250, 0.42, 0.4432, 554, 620, 630
46, 1300, 0.58, 0.448461538462, 583, 650, 650
46, 1350, 0.48, 0.44962962963, 607, 679, 671
46, 1400, 0.46, 0.45, 630, 705, 695
46, 1450, 0.42, 0.448965517241, 651, 732, 718
46, 1500, 0.48, 0.45, 675, 756, 744
46, 1550, 0.44, 0.449677419355, 697, 784, 766
46, 1600, 0.46, 0.45, 720, 806, 794
46, 1650, 0.42, 0.449090909091, 741, 833, 817
46, 1700, 0.54, 0.451764705882, 768, 855, 845
46, 1750, 0.48, 0.452571428571, 792, 876, 874
46, 1800, 0.5, 0.453888888889, 817, 896, 904
46, 1850, 0.4, 0.452432432432, 837, 922, 928
46, 1900, 0.54, 0.454736842105, 864, 945, 955
46, 1950, 0.44, 0.454358974359, 886, 964, 986
46, 2000, 0.54, 0.4565, 913, 987, 1013
47, 50, 0.38, 0.38, 19, 26, 24
47, 100, 0.46, 0.42, 42, 51, 49
47, 150, 0.5, 0.446666666667, 67, 80, 70
47, 200, 0.56, 0.475, 95, 101, 99
47, 250, 0.48, 0.476, 119, 125, 125
47, 300, 0.34, 0.453333333333, 136, 151, 149
47, 350, 0.48, 0.457142857143, 160, 174, 176
47, 400, 0.48, 0.46, 184, 199, 201
47, 450, 0.48, 0.462222222222, 208, 216, 234
47, 500, 0.52, 0.468, 234, 242, 258
47, 550, 0.58, 0.478181818182, 263, 272, 278
47, 600, 0.52, 0.481666666667, 289, 297, 303
47, 650, 0.42, 0.476923076923, 310, 325, 325
47, 700, 0.38, 0.47, 329, 351, 349
47, 750, 0.48, 0.470666666667, 353, 382, 368
47, 800, 0.44, 0.46875, 375, 402, 398
47, 850, 0.48, 0.469411764706, 399, 425, 425
47, 900, 0.56, 0.474444444444, 427, 454, 446
47, 950, 0.58, 0.48, 456, 478, 472
47, 1000, 0.58, 0.485, 485, 502, 498
47, 1050, 0.52, 0.486666666667, 511, 527, 523
47, 1100, 0.36, 0.480909090909, 529, 550, 550
47, 1150, 0.56, 0.484347826087, 557, 575, 575
47, 1200, 0.54, 0.486666666667, 584, 601, 599
47, 1250, 0.52, 0.488, 610, 618, 632
47, 1300, 0.48, 0.487692307692, 634, 638, 662
47, 1350, 0.4, 0.484444444444, 654, 664, 686
47, 1400, 0.46, 0.483571428571, 677, 686, 714
47, 1450, 0.48, 0.483448275862, 701, 700, 750
47, 1500, 0.5, 0.484, 726, 724, 776
47, 1550, 0.5, 0.484516129032, 751, 754, 796
47, 1600, 0.6, 0.488125, 781, 778, 822
47, 1650, 0.5, 0.488484848485, 806, 806, 844
47, 1700, 0.46, 0.487647058824, 829, 829, 871
47, 1750, 0.62, 0.491428571429, 860, 857, 893
47, 1800, 0.4, 0.488888888889, 880, 875, 925
47, 1850, 0.48, 0.488648648649, 904, 900, 950
47, 1900, 0.52, 0.489473684211, 930, 927, 973
47, 1950, 0.5, 0.489743589744, 955, 953, 997
47, 2000, 0.48, 0.4895, 979, 976, 1024
48, 50, 0.36, 0.36, 18, 25, 25
48, 100, 0.28, 0.32, 32, 51, 49
48, 150, 0.38, 0.34, 51, 78, 72
48, 200, 0.44, 0.365, 73, 95, 105
48, 250, 0.44, 0.38, 95, 122, 128
48, 300, 0.36, 0.376666666667, 113, 151, 149
48, 350, 0.36, 0.374285714286, 131, 173, 177
48, 400, 0.36, 0.3725, 149, 191, 209
48, 450, 0.44, 0.38, 171, 209, 241
48, 500, 0.54, 0.396, 198, 236, 264
48, 550, 0.5, 0.405454545455, 223, 253, 297
48, 600, 0.46, 0.41, 246, 276, 324
48, 650, 0.44, 0.412307692308, 268, 302, 348
48, 700, 0.56, 0.422857142857, 296, 323, 377
48, 750, 0.4, 0.421333333333, 316, 343, 407
48, 800, 0.5, 0.42625, 341, 366, 434
48, 850, 0.46, 0.428235294118, 364, 394, 456
48, 900, 0.62, 0.438888888889, 395, 418, 482
48, 950, 0.38, 0.435789473684, 414, 441, 509
48, 1000, 0.44, 0.436, 436, 459, 541
48, 1050, 0.54, 0.440952380952, 463, 485, 565
48, 1100, 0.42, 0.44, 484, 502, 598
48, 1150, 0.54, 0.444347826087, 511, 526, 624
48, 1200, 0.44, 0.444166666667, 533, 552, 648
48, 1250, 0.54, 0.448, 560, 576, 674
48, 1300, 0.48, 0.449230769231, 584, 603, 697
48, 1350, 0.5, 0.451111111111, 609, 623, 727
48, 1400, 0.52, 0.453571428571, 635, 645, 755
48, 1450, 0.44, 0.453103448276, 657, 672, 778
48, 1500, 0.42, 0.452, 678, 696, 804
48, 1550, 0.44, 0.451612903226, 700, 720, 830
48, 1600, 0.44, 0.45125, 722, 745, 855
48, 1650, 0.48, 0.452121212121, 746, 766, 884
48, 1700, 0.54, 0.454705882353, 773, 790, 910
48, 1750, 0.54, 0.457142857143, 800, 817, 933
48, 1800, 0.52, 0.458888888889, 826, 845, 955
48, 1850, 0.6, 0.462702702703, 856, 875, 975
48, 1900, 0.6, 0.466315789474, 886, 901, 999
48, 1950, 0.64, 0.470769230769, 918, 929, 1021
48, 2000, 0.6, 0.474, 948, 955, 1045
49, 50, 0.32, 0.32, 16, 27, 23
49, 100, 0.36, 0.34, 34, 48, 52
49, 150, 0.3, 0.326666666667, 49, 78, 72
49, 200, 0.36, 0.335, 67, 109, 91
49, 250, 0.4, 0.348, 87, 137, 113
49, 300, 0.36, 0.35, 105, 162, 138
49, 350, 0.38, 0.354285714286, 124, 185, 165
49, 400, 0.32, 0.35, 140, 205, 195
49, 450, 0.44, 0.36, 162, 227, 223
49, 500, 0.6, 0.384, 192, 250, 250
49, 550, 0.42, 0.387272727273, 213, 272, 278
49, 600, 0.46, 0.393333333333, 236, 294, 306
49, 650, 0.44, 0.396923076923, 258, 322, 328
49, 700, 0.48, 0.402857142857, 282, 342, 358
49, 750, 0.44, 0.405333333333, 304, 364, 386
49, 800, 0.4, 0.405, 324, 385, 415
49, 850, 0.44, 0.407058823529, 346, 411, 439
49, 900, 0.56, 0.415555555556, 374, 440, 460
49, 950, 0.62, 0.426315789474, 405, 466, 484
49, 1000, 0.44, 0.427, 427, 491, 509
49, 1050, 0.38, 0.424761904762, 446, 511, 539
49, 1100, 0.44, 0.425454545455, 468, 531, 569
49, 1150, 0.46, 0.426956521739, 491, 553, 597
49, 1200, 0.52, 0.430833333333, 517, 579, 621
49, 1250, 0.54, 0.4352, 544, 604, 646
49, 1300, 0.5, 0.437692307692, 569, 626, 674
49, 1350, 0.6, 0.443703703704, 599, 655, 695
49, 1400, 0.42, 0.442857142857, 620, 681, 719
49, 1450, 0.56, 0.446896551724, 648, 703, 747
49, 1500, 0.32, 0.442666666667, 664, 727, 773
49, 1550, 0.46, 0.443225806452, 687, 750, 800
49, 1600, 0.54, 0.44625, 714, 776, 824
49, 1650, 0.54, 0.449090909091, 741, 803, 847
49, 1700, 0.44, 0.448823529412, 763, 830, 870
49, 1750, 0.56, 0.452, 791, 853, 897
49, 1800, 0.54, 0.454444444444, 818, 878, 922
49, 1850, 0.56, 0.457297297297, 846, 901, 949
49, 1900, 0.66, 0.462631578947, 879, 928, 972
49, 1950, 0.52, 0.464102564103, 905, 956, 994
49, 2000, 0.6, 0.4675, 935, 988, 1012
50, 50, 0.36, 0.36, 18, 32, 18
50, 100, 0.36, 0.36, 36, 58, 42
50, 150, 0.38, 0.366666666667, 55, 82, 68
50, 200, 0.4, 0.375, 75, 106, 94
50, 250, 0.38, 0.376, 94, 125, 125
50, 300, 0.3, 0.363333333333, 109, 152, 148
50, 350, 0.3, 0.354285714286, 124, 179, 171
50, 400, 0.46, 0.3675, 147, 201, 199
50, 450, 0.4, 0.371111111111, 167, 221, 229
50, 500, 0.6, 0.394, 197, 249, 251
50, 550, 0.58, 0.410909090909, 226, 270, 280
50, 600, 0.46, 0.415, 249, 289, 311
50, 650, 0.42, 0.415384615385, 270, 314, 336
50, 700, 0.44, 0.417142857143, 292, 337, 363
50, 750, 0.64, 0.432, 324, 363, 387
50, 800, 0.5, 0.43625, 349, 393, 407
50, 850, 0.46, 0.437647058824, 372, 418, 432
50, 900, 0.5, 0.441111111111, 397, 440, 460
50, 950, 0.38, 0.437894736842, 416, 462, 488
50, 1000, 0.46, 0.439, 439, 489, 511
50, 1050, 0.48, 0.440952380952, 463, 519, 531
50, 1100, 0.6, 0.448181818182, 493, 544, 556
50, 1150, 0.48, 0.449565217391, 517, 568, 582
50, 1200, 0.5, 0.451666666667, 542, 593, 607
50, 1250, 0.44, 0.4512, 564, 620, 630
50, 1300, 0.54, 0.454615384615, 591, 646, 654
50, 1350, 0.48, 0.455555555556, 615, 662, 688
50, 1400, 0.5, 0.457142857143, 640, 689, 711
50, 1450, 0.52, 0.459310344828, 666, 716, 734
50, 1500, 0.52, 0.461333333333, 692, 741, 759
50, 1550, 0.44, 0.46064516129, 714, 766, 784
50, 1600, 0.54, 0.463125, 741, 793, 807
50, 1650, 0.5, 0.464242424242, 766, 819, 831
50, 1700, 0.5, 0.465294117647, 791, 840, 860
50, 1750, 0.5, 0.466285714286, 816, 863, 887
50, 1800, 0.44, 0.465555555556, 838, 887, 913
50, 1850, 0.5, 0.466486486486, 863, 912, 938
50, 1900, 0.44, 0.465789473684, 885, 937, 963
50, 1950, 0.54, 0.467692307692, 912, 961, 989
50, 2000, 0.54, 0.4695, 939, 994, 1006
51, 50, 0.4, 0.4, 20, 22, 28
51, 100, 0.36, 0.38, 38, 43, 57
51, 150, 0.4, 0.386666666667, 58, 66, 84
51, 200, 0.36, 0.38, 76, 84, 116
51, 250, 0.32, 0.368, 92, 105, 145
51, 300, 0.36, 0.366666666667, 110, 133, 167
51, 350, 0.4, 0.371428571429, 130, 155, 195
51, 400, 0.38, 0.3725, 149, 188, 212
51, 450, 0.48, 0.384444444444, 173, 212, 238
51, 500, 0.48, 0.394, 197, 231, 269
51, 550, 0.4, 0.394545454545, 217, 251, 299
51, 600, 0.7, 0.42, 252, 277, 323
51, 650, 0.64, 0.436923076923, 284, 303, 347
51, 700, 0.54, 0.444285714286, 311, 321, 379
51, 750, 0.46, 0.445333333333, 334, 358, 392
51, 800, 0.56, 0.4525, 362, 385, 415
51, 850, 0.66, 0.464705882353, 395, 410, 440
51, 900, 0.52, 0.467777777778, 421, 434, 466
51, 950, 0.48, 0.468421052632, 445, 458, 492
51, 1000, 0.64, 0.477, 477, 487, 513
51, 1050, 0.48, 0.477142857143, 501, 509, 541
51, 1100, 0.5, 0.478181818182, 526, 529, 571
51, 1150, 0.5, 0.479130434783, 551, 547, 603
51, 1200, 0.42, 0.476666666667, 572, 573, 627
51, 1250, 0.42, 0.4744, 593, 601, 649
51, 1300, 0.62, 0.48, 624, 630, 670
51, 1350, 0.5, 0.480740740741, 649, 654, 696
51, 1400, 0.38, 0.477142857143, 668, 679, 721
51, 1450, 0.48, 0.47724137931, 692, 699, 751
51, 1500, 0.48, 0.477333333333, 716, 727, 773
51, 1550, 0.46, 0.476774193548, 739, 756, 794
51, 1600, 0.36, 0.473125, 757, 779, 821
51, 1650, 0.48, 0.473333333333, 781, 808, 842
51, 1700, 0.54, 0.475294117647, 808, 835, 865
51, 1750, 0.48, 0.475428571429, 832, 862, 888
51, 1800, 0.42, 0.473888888889, 853, 884, 916
51, 1850, 0.62, 0.477837837838, 884, 915, 935
51, 1900, 0.52, 0.478947368421, 910, 941, 959
51, 1950, 0.54, 0.480512820513, 937, 963, 987
51, 2000, 0.48, 0.4805, 961, 984, 1016
52, 50, 0.34, 0.34, 17, 27, 23
52, 100, 0.46, 0.4, 40, 55, 45
52, 150, 0.22, 0.34, 51, 75, 75
52, 200, 0.48, 0.375, 75, 104, 96
52, 250, 0.38, 0.376, 94, 135, 115
52, 300, 0.44, 0.386666666667, 116, 152, 148
52, 350, 0.3, 0.374285714286, 131, 177, 173
52, 400, 0.42, 0.38, 152, 199, 201
52, 450, 0.6, 0.404444444444, 182, 231, 219
52, 500, 0.44, 0.408, 204, 252, 248
52, 550, 0.58, 0.423636363636, 233, 281, 269
52, 600, 0.46, 0.426666666667, 256, 304, 296
52, 650, 0.58, 0.438461538462, 285, 325, 325
52, 700, 0.6, 0.45, 315, 349, 351
52, 750, 0.58, 0.458666666667, 344, 375, 375
52, 800, 0.42, 0.45625, 365, 394, 406
52, 850, 0.38, 0.451764705882, 384, 418, 432
52, 900, 0.56, 0.457777777778, 412, 450, 450
52, 950, 0.46, 0.457894736842, 435, 472, 478
52, 1000, 0.54, 0.462, 462, 499, 501
52, 1050, 0.46, 0.461904761905, 485, 522, 528
52, 1100, 0.46, 0.461818181818, 508, 546, 554
52, 1150, 0.56, 0.466086956522, 536, 572, 578
52, 1200, 0.54, 0.469166666667, 563, 598, 602
52, 1250, 0.56, 0.4728, 591, 625, 625
52, 1300, 0.5, 0.473846153846, 616, 651, 649
52, 1350, 0.56, 0.477037037037, 644, 675, 675
52, 1400, 0.52, 0.478571428571, 670, 708, 692
52, 1450, 0.44, 0.47724137931, 692, 735, 715
52, 1500, 0.56, 0.48, 720, 761, 739
52, 1550, 0.5, 0.48064516129, 745, 785, 765
52, 1600, 0.4, 0.478125, 765, 812, 788
52, 1650, 0.44, 0.47696969697, 787, 839, 811
52, 1700, 0.46, 0.476470588235, 810, 855, 845
52, 1750, 0.52, 0.477714285714, 836, 888, 862
52, 1800, 0.42, 0.476111111111, 857, 912, 888
52, 1850, 0.48, 0.476216216216, 881, 937, 913
52, 1900, 0.42, 0.474736842105, 902, 957, 943
52, 1950, 0.5, 0.475384615385, 927, 982, 968
52, 2000, 0.48, 0.4755, 951, 1003, 997
53, 50, 0.44, 0.44, 22, 18, 32
53, 100, 0.38, 0.41, 41, 41, 59
53, 150, 0.3, 0.373333333333, 56, 63, 87
53, 200, 0.38, 0.375, 75, 89, 111
53, 250, 0.38, 0.376, 94, 109, 141
53, 300, 0.4, 0.38, 114, 130, 170
53, 350, 0.36, 0.377142857143, 132, 157, 193
53, 400, 0.34, 0.3725, 149, 184, 216
53, 450, 0.46, 0.382222222222, 172, 210, 240
53, 500, 0.52, 0.396, 198, 237, 263
53, 550, 0.38, 0.394545454545, 217, 262, 288
53, 600, 0.46, 0.4, 240, 284, 316
53, 650, 0.46, 0.404615384615, 263, 311, 339
53, 700, 0.34, 0.4, 280, 334, 366
53, 750, 0.56, 0.410666666667, 308, 358, 392
53, 800, 0.48, 0.415, 332, 378, 422
53, 850, 0.44, 0.416470588235, 354, 403, 447
53, 900, 0.46, 0.418888888889, 377, 427, 473
53, 950, 0.4, 0.417894736842, 397, 443, 507
53, 1000, 0.54, 0.424, 424, 468, 532
53, 1050, 0.5, 0.427619047619, 449, 495, 555
53, 1100, 0.5, 0.430909090909, 474, 520, 580
53, 1150, 0.52, 0.434782608696, 500, 547, 603
53, 1200, 0.62, 0.4425, 531, 574, 626
53, 1250, 0.6, 0.4488, 561, 603, 647
53, 1300, 0.42, 0.447692307692, 582, 623, 677
53, 1350, 0.52, 0.45037037037, 608, 651, 699
53, 1400, 0.48, 0.451428571429, 632, 678, 722
53, 1450, 0.56, 0.455172413793, 660, 711, 739
53, 1500, 0.58, 0.459333333333, 689, 737, 763
53, 1550, 0.52, 0.461290322581, 715, 765, 785
53, 1600, 0.44, 0.460625, 737, 795, 805
53, 1650, 0.46, 0.460606060606, 760, 814, 836
53, 1700, 0.42, 0.459411764706, 781, 838, 862
53, 1750, 0.54, 0.461714285714, 808, 870, 880
53, 1800, 0.52, 0.463333333333, 834, 897, 903
53, 1850, 0.5, 0.464324324324, 859, 920, 930
53, 1900, 0.5, 0.465263157895, 884, 941, 959
53, 1950, 0.42, 0.464102564103, 905, 967, 983
53, 2000, 0.58, 0.467, 934, 997, 1003
54, 50, 0.4, 0.4, 20, 22, 28
54, 100, 0.4, 0.4, 40, 47, 53
54, 150, 0.24, 0.346666666667, 52, 70, 80
54, 200, 0.34, 0.345, 69, 92, 108
54, 250, 0.3, 0.336, 84, 110, 140
54, 300, 0.32, 0.333333333333, 100, 137, 163
54, 350, 0.42, 0.345714285714, 121, 165, 185
54, 400, 0.36, 0.3475, 139, 187, 213
54, 450, 0.42, 0.355555555556, 160, 216, 234
54, 500, 0.38, 0.358, 179, 240, 260
54, 550, 0.48, 0.369090909091, 203, 257, 293
54, 600, 0.48, 0.378333333333, 227, 278, 322
54, 650, 0.34, 0.375384615385, 244, 300, 350
54, 700, 0.52, 0.385714285714, 270, 329, 371
54, 750, 0.48, 0.392, 294, 356, 394
54, 800, 0.4, 0.3925, 314, 377, 423
54, 850, 0.44, 0.395294117647, 336, 404, 446
54, 900, 0.52, 0.402222222222, 362, 424, 476
54, 950, 0.44, 0.404210526316, 384, 450, 500
54, 1000, 0.6, 0.414, 414, 477, 523
54, 1050, 0.48, 0.417142857143, 438, 498, 552
54, 1100, 0.48, 0.42, 462, 518, 582
54, 1150, 0.52, 0.424347826087, 488, 545, 605
54, 1200, 0.36, 0.421666666667, 506, 569, 631
54, 1250, 0.46, 0.4232, 529, 589, 661
54, 1300, 0.48, 0.425384615385, 553, 614, 686
54, 1350, 0.44, 0.425925925926, 575, 639, 711
54, 1400, 0.52, 0.429285714286, 601, 662, 738
54, 1450, 0.36, 0.426896551724, 619, 690, 760
54, 1500, 0.48, 0.428666666667, 643, 715, 785
54, 1550, 0.52, 0.431612903226, 669, 739, 811
54, 1600, 0.62, 0.4375, 700, 770, 830
54, 1650, 0.44, 0.437575757576, 722, 792, 858
54, 1700, 0.38, 0.435882352941, 741, 818, 882
54, 1750, 0.48, 0.437142857143, 765, 838, 912
54, 1800, 0.54, 0.44, 792, 862, 938
54, 1850, 0.44, 0.44, 814, 884, 966
54, 1900, 0.68, 0.446315789474, 848, 906, 994
54, 1950, 0.48, 0.447179487179, 872, 931, 1019
54, 2000, 0.52, 0.449, 898, 956, 1044
55, 50, 0.26, 0.26, 13, 27, 23
55, 100, 0.4, 0.33, 33, 53, 47
55, 150, 0.36, 0.34, 51, 82, 68
55, 200, 0.32, 0.335, 67, 111, 89
55, 250, 0.32, 0.332, 83, 135, 115
55, 300, 0.34, 0.333333333333, 100, 160, 140
55, 350, 0.22, 0.317142857143, 111, 186, 164
55, 400, 0.2, 0.3025, 121, 209, 191
55, 450, 0.4, 0.313333333333, 141, 231, 219
55, 500, 0.46, 0.328, 164, 260, 240
55, 550, 0.5, 0.343636363636, 189, 286, 264
55, 600, 0.5, 0.356666666667, 214, 307, 293
55, 650, 0.42, 0.361538461538, 235, 337, 313
55, 700, 0.68, 0.384285714286, 269, 368, 332
55, 750, 0.46, 0.389333333333, 292, 390, 360
55, 800, 0.54, 0.39875, 319, 422, 378
55, 850, 0.4, 0.398823529412, 339, 450, 400
55, 900, 0.46, 0.402222222222, 362, 476, 424
55, 950, 0.44, 0.404210526316, 384, 494, 456
55, 1000, 0.4, 0.404, 404, 517, 483
55, 1050, 0.48, 0.407619047619, 428, 534, 516
55, 1100, 0.4, 0.407272727273, 448, 554, 546
55, 1150, 0.58, 0.414782608696, 477, 581, 569
55, 1200, 0.58, 0.421666666667, 506, 607, 593
55, 1250, 0.52, 0.4256, 532, 631, 619
55, 1300, 0.52, 0.429230769231, 558, 648, 652
55, 1350, 0.46, 0.43037037037, 581, 677, 673
55, 1400, 0.48, 0.432142857143, 605, 704, 696
55, 1450, 0.42, 0.431724137931, 626, 724, 726
55, 1500, 0.5, 0.434, 651, 746, 754
55, 1550, 0.46, 0.434838709677, 674, 773, 777
55, 1600, 0.54, 0.438125, 701, 797, 803
55, 1650, 0.44, 0.438181818182, 723, 822, 828
55, 1700, 0.48, 0.439411764706, 747, 853, 847
55, 1750, 0.6, 0.444, 777, 880, 870
55, 1800, 0.56, 0.447222222222, 805, 905, 895
55, 1850, 0.48, 0.448108108108, 829, 933, 917
55, 1900, 0.62, 0.452631578947, 860, 961, 939
55, 1950, 0.58, 0.455897435897, 889, 979, 971
55, 2000, 0.64, 0.4605, 921, 1005, 995
56, 50, 0.36, 0.36, 18, 18, 32
56, 100, 0.28, 0.32, 32, 42, 58
56, 150, 0.38, 0.34, 51, 68, 82
56, 200, 0.46, 0.37, 74, 95, 105
56, 250, 0.42, 0.38, 95, 117, 133
56, 300, 0.48, 0.396666666667, 119, 142, 158
56, 350, 0.38, 0.394285714286, 138, 168, 182
56, 400, 0.46, 0.4025, 161, 192, 208
56, 450, 0.42, 0.404444444444, 182, 218, 232
56, 500, 0.46, 0.41, 205, 243, 257
56, 550, 0.4, 0.409090909091, 225, 266, 284
56, 600, 0.4, 0.408333333333, 245, 288, 312
56, 650, 0.58, 0.421538461538, 274, 313, 337
56, 700, 0.46, 0.424285714286, 297, 341, 359
56, 750, 0.6, 0.436, 327, 370, 380
56, 800, 0.6, 0.44625, 357, 390, 410
56, 850, 0.52, 0.450588235294, 383, 413, 437
56, 900, 0.5, 0.453333333333, 408, 442, 458
56, 950, 0.4, 0.450526315789, 428, 470, 480
56, 1000, 0.42, 0.449, 449, 491, 509
56, 1050, 0.42, 0.447619047619, 470, 514, 536
56, 1100, 0.6, 0.454545454545, 500, 540, 560
56, 1150, 0.52, 0.457391304348, 526, 563, 587
56, 1200, 0.5, 0.459166666667, 551, 591, 609
56, 1250, 0.32, 0.4536, 567, 616, 634
56, 1300, 0.4, 0.451538461538, 587, 646, 654
56, 1350, 0.48, 0.452592592593, 611, 668, 682
56, 1400, 0.4, 0.450714285714, 631, 696, 704
56, 1450, 0.54, 0.453793103448, 658, 724, 726
56, 1500, 0.46, 0.454, 681, 744, 756
56, 1550, 0.56, 0.457419354839, 709, 769, 781
56, 1600, 0.48, 0.458125, 733, 795, 805
56, 1650, 0.38, 0.455757575758, 752, 815, 835
56, 1700, 0.32, 0.451764705882, 768, 841, 859
56, 1750, 0.48, 0.452571428571, 792, 867, 883
56, 1800, 0.5, 0.453888888889, 817, 883, 917
56, 1850, 0.56, 0.456756756757, 845, 915, 935
56, 1900, 0.52, 0.458421052632, 871, 937, 963
56, 1950, 0.44, 0.457948717949, 893, 965, 985
56, 2000, 0.52, 0.4595, 919, 991, 1009
57, 50, 0.34, 0.34, 17, 26, 24
57, 100, 0.28, 0.31, 31, 52, 48
57, 150, 0.44, 0.353333333333, 53, 76, 74
57, 200, 0.36, 0.355, 71, 108, 92
57, 250, 0.28, 0.34, 85, 126, 124
57, 300, 0.32, 0.336666666667, 101, 157, 143
57, 350, 0.36, 0.34, 119, 172, 178
57, 400, 0.52, 0.3625, 145, 198, 202
57, 450, 0.56, 0.384444444444, 173, 227, 223
57, 500, 0.54, 0.4, 200, 254, 246
57, 550, 0.52, 0.410909090909, 226, 279, 271
57, 600, 0.56, 0.423333333333, 254, 303, 297
57, 650, 0.54, 0.432307692308, 281, 336, 314
57, 700, 0.52, 0.438571428571, 307, 359, 341
57, 750, 0.46, 0.44, 330, 388, 362
57, 800, 0.5, 0.44375, 355, 413, 387
57, 850, 0.5, 0.447058823529, 380, 432, 418
57, 900, 0.5, 0.45, 405, 455, 445
57, 950, 0.5, 0.452631578947, 430, 480, 470
57, 1000, 0.5, 0.455, 455, 503, 497
57, 1050, 0.54, 0.459047619048, 482, 529, 521
57, 1100, 0.44, 0.458181818182, 504, 550, 550
57, 1150, 0.6, 0.464347826087, 534, 584, 566
57, 1200, 0.38, 0.460833333333, 553, 606, 594
57, 1250, 0.36, 0.4568, 571, 630, 620
57, 1300, 0.46, 0.456923076923, 594, 655, 645
57, 1350, 0.46, 0.457037037037, 617, 677, 673
57, 1400, 0.62, 0.462857142857, 648, 699, 701
57, 1450, 0.6, 0.467586206897, 678, 724, 726
57, 1500, 0.64, 0.473333333333, 710, 748, 752
57, 1550, 0.54, 0.475483870968, 737, 771, 779
57, 1600, 0.52, 0.476875, 763, 798, 802
57, 1650, 0.54, 0.478787878788, 790, 822, 828
57, 1700, 0.52, 0.48, 816, 843, 857
57, 1750, 0.36, 0.476571428571, 834, 874, 876
57, 1800, 0.44, 0.475555555556, 856, 898, 902
57, 1850, 0.54, 0.477297297297, 883, 922, 928
57, 1900, 0.38, 0.474736842105, 902, 944, 956
57, 1950, 0.48, 0.474871794872, 926, 976, 974
57, 2000, 0.36, 0.472, 944, 1002, 998
58, 50, 0.36, 0.36, 18, 20, 30
58, 100, 0.38, 0.37, 37, 43, 57
58, 150, 0.46, 0.4, 60, 68, 82
58, 200, 0.42, 0.405, 81, 95, 105
58, 250, 0.5, 0.424, 106, 123, 127
58, 300, 0.48, 0.433333333333, 130, 144, 156
58, 350, 0.44, 0.434285714286, 152, 170, 180
58, 400, 0.48, 0.44, 176, 196, 204
58, 450, 0.46, 0.442222222222, 199, 223, 227
58, 500, 0.7, 0.468, 234, 249, 251
58, 550, 0.56, 0.476363636364, 262, 277, 273
58, 600, 0.42, 0.471666666667, 283, 305, 295
58, 650, 0.5, 0.473846153846, 308, 330, 320
58, 700, 0.48, 0.474285714286, 332, 357, 343
58, 750, 0.6, 0.482666666667, 362, 386, 364
58, 800, 0.54, 0.48625, 389, 409, 391
58, 850, 0.56, 0.490588235294, 417, 436, 414
58, 900, 0.46, 0.488888888889, 440, 465, 435
58, 950, 0.52, 0.490526315789, 466, 488, 462
58, 1000, 0.44, 0.488, 488, 513, 487
58, 1050, 0.54, 0.490476190476, 515, 538, 512
58, 1100, 0.56, 0.493636363636, 543, 562, 538
58, 1150, 0.6, 0.498260869565, 573, 584, 566
58, 1200, 0.48, 0.4975, 597, 611, 589
58, 1250, 0.46, 0.496, 620, 640, 610
58, 1300, 0.5, 0.496153846154, 645, 663, 637
58, 1350, 0.5, 0.496296296296, 670, 693, 657
58, 1400, 0.68, 0.502857142857, 704, 721, 679
58, 1450, 0.44, 0.500689655172, 726, 750, 700
58, 1500, 0.48, 0.5, 750, 779, 721
58, 1550, 0.42, 0.497419354839, 771, 803, 747
58, 1600, 0.64, 0.501875, 803, 826, 774
58, 1650, 0.54, 0.50303030303, 830, 854, 796
58, 1700, 0.46, 0.501764705882, 853, 879, 821
58, 1750, 0.34, 0.497142857143, 870, 905, 845
58, 1800, 0.56, 0.498888888889, 898, 937, 863
58, 1850, 0.46, 0.497837837838, 921, 968, 882
58, 1900, 0.48, 0.497368421053, 945, 988, 912
58, 1950, 0.52, 0.497948717949, 971, 1015, 935
58, 2000, 0.46, 0.497, 994, 1044, 956
59, 50, 0.32, 0.32, 16, 31, 19
59, 100, 0.26, 0.29, 29, 53, 47
59, 150, 0.38, 0.32, 48, 81, 69
59, 200, 0.46, 0.355, 71, 99, 101
59, 250, 0.28, 0.34, 85, 118, 132
59, 300, 0.3, 0.333333333333, 100, 139, 161
59, 350, 0.28, 0.325714285714, 114, 168, 182
59, 400, 0.44, 0.34, 136, 196, 204
59, 450, 0.5, 0.357777777778, 161, 218, 232
59, 500, 0.48, 0.37, 185, 237, 263
59, 550, 0.56, 0.387272727273, 213, 259, 291
59, 600, 0.6, 0.405, 243, 283, 317
59, 650, 0.52, 0.413846153846, 269, 307, 343
59, 700, 0.5, 0.42, 294, 336, 364
59, 750, 0.48, 0.424, 318, 358, 392
59, 800, 0.48, 0.4275, 342, 378, 422
59, 850, 0.52, 0.432941176471, 368, 401, 449
59, 900, 0.44, 0.433333333333, 390, 426, 474
59, 950, 0.48, 0.435789473684, 414, 446, 504
59, 1000, 0.62, 0.445, 445, 474, 526
59, 1050, 0.46, 0.445714285714, 468, 501, 549
59, 1100, 0.52, 0.449090909091, 494, 521, 579
59, 1150, 0.56, 0.453913043478, 522, 539, 611
59, 1200, 0.46, 0.454166666667, 545, 565, 635
59, 1250, 0.46, 0.4544, 568, 591, 659
59, 1300, 0.46, 0.454615384615, 591, 622, 678
59, 1350, 0.56, 0.458518518519, 619, 645, 705
59, 1400, 0.48, 0.459285714286, 643, 668, 732
59, 1450, 0.42, 0.457931034483, 664, 688, 762
59, 1500, 0.58, 0.462, 693, 720, 780
59, 1550, 0.54, 0.464516129032, 720, 736, 814
59, 1600, 0.48, 0.465, 744, 765, 835
59, 1650, 0.5, 0.466060606061, 769, 790, 860
59, 1700, 0.5, 0.467058823529, 794, 817, 883
59, 1750, 0.62, 0.471428571429, 825, 842, 908
59, 1800, 0.44, 0.470555555556, 847, 870, 930
59, 1850, 0.34, 0.467027027027, 864, 891, 959
59, 1900, 0.54, 0.468947368421, 891, 919, 981
59, 1950, 0.5, 0.469743589744, 916, 942, 1008
59, 2000, 0.38, 0.4675, 935, 973, 1027
60, 50, 0.5, 0.5, 25, 25, 25
60, 100, 0.42, 0.46, 46, 48, 52
60, 150, 0.46, 0.46, 69, 72, 78
60, 200, 0.44, 0.455, 91, 101, 99
60, 250, 0.36, 0.436, 109, 128, 122
60, 300, 0.28, 0.41, 123, 155, 145
60, 350, 0.42, 0.411428571429, 144, 180, 170
60, 400, 0.32, 0.4, 160, 201, 199
60, 450, 0.44, 0.404444444444, 182, 222, 228
60, 500, 0.54, 0.418, 209, 250, 250
60, 550, 0.48, 0.423636363636, 233, 279, 271
60, 600, 0.42, 0.423333333333, 254, 302, 298
60, 650, 0.38, 0.42, 273, 324, 326
60, 700, 0.48, 0.424285714286, 297, 346, 354
60, 750, 0.42, 0.424, 318, 367, 383
60, 800, 0.5, 0.42875, 343, 393, 407
60, 850, 0.54, 0.435294117647, 370, 418, 432
60, 900, 0.46, 0.436666666667, 393, 439, 461
60, 950, 0.6, 0.445263157895, 423, 469, 481
60, 1000, 0.54, 0.45, 450, 494, 506
60, 1050, 0.58, 0.45619047619, 479, 523, 527
60, 1100, 0.46, 0.456363636364, 502, 543, 557
60, 1150, 0.5, 0.458260869565, 527, 569, 581
60, 1200, 0.56, 0.4625, 555, 595, 605
60, 1250, 0.48, 0.4632, 579, 619, 631
60, 1300, 0.5, 0.464615384615, 604, 646, 654
60, 1350, 0.54, 0.467407407407, 631, 676, 674
60, 1400, 0.58, 0.471428571429, 660, 703, 697
60, 1450, 0.5, 0.472413793103, 685, 724, 726
60, 1500, 0.46, 0.472, 708, 749, 751
60, 1550, 0.48, 0.472258064516, 732, 773, 777
60, 1600, 0.46, 0.471875, 755, 798, 802
60, 1650, 0.52, 0.473333333333, 781, 821, 829
60, 1700, 0.48, 0.473529411765, 805, 847, 853
60, 1750, 0.52, 0.474857142857, 831, 871, 879
60, 1800, 0.46, 0.474444444444, 854, 894, 906
60, 1850, 0.46, 0.474054054054, 877, 918, 932
60, 1900, 0.52, 0.475263157895, 903, 946, 954
60, 1950, 0.58, 0.477948717949, 932, 982, 968
60, 2000, 0.42, 0.4765, 953, 1001, 999