simulation, visitors, current conversion rate, overall conversion rate, total conversions, pulls arm 1, pulls arm 2
0, 50, 0.36, 0.36, 18, 23, 27
0, 100, 0.4, 0.38, 38, 50, 50
0, 150, 0.46, 0.406666666667, 61, 70, 80
0, 200, 0.36, 0.395, 79, 97, 103
0, 250, 0.36, 0.388, 97, 124, 126
0, 300, 0.38, 0.386666666667, 116, 149, 151
0, 350, 0.3, 0.374285714286, 131, 171, 179
0, 400, 0.54, 0.395, 158, 196, 204
0, 450, 0.28, 0.382222222222, 172, 224, 226
0, 500, 0.34, 0.378, 189, 252, 248
0, 550, 0.4, 0.38, 209, 280, 270
0, 600, 0.3, 0.373333333333, 224, 313, 287
0, 650, 0.3, 0.367692307692, 239, 337, 313
0, 700, 0.42, 0.371428571429, 260, 362, 338
0, 750, 0.4, 0.373333333333, 280, 383, 367
0, 800, 0.42, 0.37625, 301, 399, 401
0, 850, 0.46, 0.381176470588, 324, 420, 430
0, 900, 0.5, 0.387777777778, 349, 440, 460
0, 950, 0.44, 0.390526315789, 371, 465, 485
0, 1000, 0.26, 0.384, 384, 485, 515
0, 1050, 0.34, 0.381904761905, 401, 505, 545
0, 1100, 0.42, 0.383636363636, 422, 528, 572
0, 1150, 0.42, 0.385217391304, 443, 547, 603
0, 1200, 0.32, 0.3825, 459, 563, 637
0, 1250, 0.28, 0.3784, 473, 575, 675
0, 1300, 0.4, 0.379230769231, 493, 589, 711
0, 1350, 0.32, 0.377037037037, 509, 600, 750
0, 1400, 0.36, 0.376428571429, 527, 618, 782
0, 1450, 0.48, 0.38, 551, 637, 813
0, 1500, 0.48, 0.383333333333, 575, 647, 853
0, 1550, 0.34, 0.381935483871, 592, 653, 897
0, 1600, 0.44, 0.38375, 614, 666, 934
0, 1650, 0.5, 0.387272727273, 639, 675, 975
0, 1700, 0.3, 0.384705882353, 654, 683, 1017
0, 1750, 0.42, 0.385714285714, 675, 694, 1056
0, 1800, 0.34, 0.384444444444, 692, 702, 1098
0, 1850, 0.34, 0.383243243243, 709, 713, 1137
0, 1900, 0.32, 0.381578947368, 725, 723, 1177
0, 1950, 0.34, 0.380512820513, 742, 734, 1216
0, 2000, 0.38, 0.3805, 761, 747, 1253
1, 50, 0.54, 0.54, 27, 21, 29
1, 100, 0.42, 0.48, 48, 46, 54
1, 150, 0.28, 0.413333333333, 62, 68, 82
1, 200, 0.46, 0.425, 85, 86, 114
1, 250, 0.4, 0.42, 105, 112, 138
1, 300, 0.3, 0.4, 120, 139, 161
1, 350, 0.26, 0.38, 133, 166, 184
1, 400, 0.32, 0.3725, 149, 195, 205
1, 450, 0.36, 0.371111111111, 167, 218, 232
1, 500, 0.42, 0.376, 188, 232, 268
1, 550, 0.36, 0.374545454545, 206, 254, 296
1, 600, 0.36, 0.373333333333, 224, 278, 322
1, 650, 0.3, 0.367692307692, 239, 302, 348
1, 700, 0.36, 0.367142857143, 257, 322, 378
1, 750, 0.36, 0.366666666667, 275, 349, 401
1, 800, 0.52, 0.37625, 301, 372, 428
1, 850, 0.42, 0.378823529412, 322, 388, 462
1, 900, 0.24, 0.371111111111, 334, 408, 492
1, 950, 0.38, 0.371578947368, 353, 431, 519
1, 1000, 0.44, 0.375, 375, 448, 552
1, 1050, 0.48, 0.38, 399, 466, 584
1, 1100, 0.42, 0.381818181818, 420, 486, 614
1, 1150, 0.44, 0.384347826087, 442, 508, 642
1, 1200, 0.3, 0.380833333333, 457, 529, 671
1, 1250, 0.46, 0.384, 480, 546, 704
1, 1300, 0.38, 0.383846153846, 499, 565, 735
1, 1350, 0.42, 0.385185185185, 520, 581, 769
1, 1400, 0.4, 0.385714285714, 540, 599, 801
1, 1450, 0.34, 0.384137931034, 557, 612, 838
1, 1500, 0.42, 0.385333333333, 578, 619, 881
1, 1550, 0.4, 0.385806451613, 598, 632, 918
1, 1600, 0.44, 0.3875, 620, 642, 958
1, 1650, 0.5, 0.390909090909, 645, 648, 1002
1, 1700, 0.34, 0.389411764706, 662, 655, 1045
1, 1750, 0.38, 0.389142857143, 681, 658, 1092
1, 1800, 0.38, 0.388888888889, 700, 665, 1135
1, 1850, 0.36, 0.388108108108, 718, 669, 1181
1, 1900, 0.4, 0.388421052632, 738, 674, 1226
1, 1950, 0.28, 0.385641025641, 752, 677, 1273
1, 2000, 0.36, 0.385, 770, 684, 1316
2, 50, 0.48, 0.48, 24, 24, 26
2, 100, 0.4, 0.44, 44, 53, 47
2, 150, 0.46, 0.446666666667, 67, 74, 76
2, 200, 0.38, 0.43, 86, 97, 103
2, 250, 0.3, 0.404, 101, 124, 126
2, 300, 0.28, 0.383333333333, 115, 148, 152
2, 350, 0.46, 0.394285714286, 138, 167, 183
2, 400, 0.3, 0.3825, 153, 194, 206
2, 450, 0.46, 0.391111111111, 176, 225, 225
2, 500, 0.4, 0.392, 196, 253, 247
2, 550, 0.38, 0.390909090909, 215, 283, 267
2, 600, 0.3, 0.383333333333, 230, 319, 281
2, 650, 0.38, 0.383076923077, 249, 352, 298
2, 700, 0.48, 0.39, 273, 383, 317
2, 750, 0.42, 0.392, 294, 410, 340
2, 800, 0.32, 0.3875, 310, 435, 365
2, 850, 0.26, 0.38, 323, 466, 384
2, 900, 0.3, 0.375555555556, 338, 488, 412
2, 950, 0.46, 0.38, 361, 506, 444
2, 1000, 0.34, 0.378, 378, 533, 467
2, 1050, 0.42, 0.38, 399, 573, 477
2, 1100, 0.38, 0.38, 418, 607, 493
2, 1150, 0.34, 0.378260869565, 435, 647, 503
2, 1200, 0.42, 0.38, 456, 689, 511
2, 1250, 0.3, 0.3768, 471, 730, 520
2, 1300, 0.34, 0.375384615385, 488, 773, 527
2, 1350, 0.32, 0.373333333333, 504, 819, 531
2, 1400, 0.5, 0.377857142857, 529, 857, 543
2, 1450, 0.46, 0.380689655172, 552, 900, 550
2, 1500, 0.46, 0.383333333333, 575, 941, 559
2, 1550, 0.46, 0.385806451613, 598, 982, 568
2, 1600, 0.38, 0.385625, 617, 1023, 577
2, 1650, 0.4, 0.386060606061, 637, 1066, 584
2, 1700, 0.42, 0.387058823529, 658, 1110, 590
2, 1750, 0.5, 0.390285714286, 683, 1157, 593
2, 1800, 0.38, 0.39, 702, 1206, 594
2, 1850, 0.38, 0.38972972973, 721, 1253, 597
2, 1900, 0.54, 0.393684210526, 748, 1297, 603
2, 1950, 0.34, 0.392307692308, 765, 1342, 608
2, 2000, 0.44, 0.3935, 787, 1390, 610
3, 50, 0.4, 0.4, 20, 29, 21
3, 100, 0.52, 0.46, 46, 56, 44
3, 150, 0.5, 0.473333333333, 71, 83, 67
3, 200, 0.32, 0.435, 87, 107, 93
3, 250, 0.38, 0.424, 106, 136, 114
3, 300, 0.46, 0.43, 129, 167, 133
3, 350, 0.42, 0.428571428571, 150, 194, 156
3, 400, 0.34, 0.4175, 167, 212, 188
3, 450, 0.46, 0.422222222222, 190, 222, 228
3, 500, 0.5, 0.43, 215, 231, 269
3, 550, 0.56, 0.441818181818, 243, 235, 315
3, 600, 0.38, 0.436666666667, 262, 239, 361
3, 650, 0.44, 0.436923076923, 284, 248, 402
3, 700, 0.38, 0.432857142857, 303, 260, 440
3, 750, 0.4, 0.430666666667, 323, 267, 483
3, 800, 0.4, 0.42875, 343, 278, 522
3, 850, 0.42, 0.428235294118, 364, 282, 568
3, 900, 0.4, 0.426666666667, 384, 288, 612
3, 950, 0.5, 0.430526315789, 409, 294, 656
3, 1000, 0.36, 0.427, 427, 298, 702
3, 1050, 0.34, 0.422857142857, 444, 299, 751
3, 1100, 0.42, 0.422727272727, 465, 306, 794
3, 1150, 0.46, 0.424347826087, 488, 309, 841
3, 1200, 0.38, 0.4225, 507, 313, 887
3, 1250, 0.26, 0.416, 520, 319, 931
3, 1300, 0.46, 0.417692307692, 543, 327, 973
3, 1350, 0.42, 0.417777777778, 564, 335, 1015
3, 1400, 0.54, 0.422142857143, 591, 340, 1060
3, 1450, 0.34, 0.419310344828, 608, 351, 1099
3, 1500, 0.38, 0.418, 627, 364, 1136
3, 1550, 0.38, 0.416774193548, 646, 368, 1182
3, 1600, 0.5, 0.419375, 671, 374, 1226
3, 1650, 0.34, 0.41696969697, 688, 383, 1267
3, 1700, 0.4, 0.416470588235, 708, 388, 1312
3, 1750, 0.46, 0.417714285714, 731, 396, 1354
3, 1800, 0.46, 0.418888888889, 754, 401, 1399
3, 1850, 0.48, 0.420540540541, 778, 407, 1443
3, 1900, 0.28, 0.416842105263, 792, 416, 1484
3, 1950, 0.34, 0.414871794872, 809, 424, 1526
3, 2000, 0.46, 0.416, 832, 442, 1558
4, 50, 0.28, 0.28, 14, 25, 25
4, 100, 0.36, 0.32, 32, 52, 48
4, 150, 0.38, 0.34, 51, 74, 76
4, 200, 0.38, 0.35, 70, 98, 102
4, 250, 0.46, 0.372, 93, 117, 133
4, 300, 0.36, 0.37, 111, 141, 159
4, 350, 0.32, 0.362857142857, 127, 168, 182
4, 400, 0.36, 0.3625, 145, 194, 206
4, 450, 0.44, 0.371111111111, 167, 222, 228
4, 500, 0.34, 0.368, 184, 244, 256
4, 550, 0.46, 0.376363636364, 207, 252, 298
4, 600, 0.34, 0.373333333333, 224, 257, 343
4, 650, 0.3, 0.367692307692, 239, 268, 382
4, 700, 0.34, 0.365714285714, 256, 279, 421
4, 750, 0.46, 0.372, 279, 293, 457
4, 800, 0.4, 0.37375, 299, 301, 499
4, 850, 0.3, 0.369411764706, 314, 314, 536
4, 900, 0.4, 0.371111111111, 334, 320, 580
4, 950, 0.46, 0.375789473684, 357, 332, 618
4, 1000, 0.32, 0.373, 373, 347, 653
4, 1050, 0.42, 0.375238095238, 394, 359, 691
4, 1100, 0.48, 0.38, 418, 364, 736
4, 1150, 0.4, 0.380869565217, 438, 372, 778
4, 1200, 0.48, 0.385, 462, 377, 823
4, 1250, 0.32, 0.3824, 478, 378, 872
4, 1300, 0.32, 0.38, 494, 386, 914
4, 1350, 0.34, 0.378518518519, 511, 397, 953
4, 1400, 0.52, 0.383571428571, 537, 411, 989
4, 1450, 0.46, 0.386206896552, 560, 429, 1021
4, 1500, 0.36, 0.385333333333, 578, 449, 1051
4, 1550, 0.4, 0.385806451613, 598, 468, 1082
4, 1600, 0.26, 0.381875, 611, 484, 1116
4, 1650, 0.28, 0.378787878788, 625, 496, 1154
4, 1700, 0.38, 0.378823529412, 644, 504, 1196
4, 1750, 0.46, 0.381142857143, 667, 513, 1237
4, 1800, 0.42, 0.382222222222, 688, 524, 1276
4, 1850, 0.46, 0.384324324324, 711, 536, 1314
4, 1900, 0.48, 0.386842105263, 735, 547, 1353
4, 1950, 0.4, 0.387179487179, 755, 558, 1392
4, 2000, 0.32, 0.3855, 771, 574, 1426
5, 50, 0.44, 0.44, 22, 21, 29
5, 100, 0.44, 0.44, 44, 47, 53
5, 150, 0.38, 0.42, 63, 74, 76
5, 200, 0.22, 0.37, 74, 100, 100
5, 250, 0.36, 0.368, 92, 122, 128
5, 300, 0.36, 0.366666666667, 110, 144, 156
5, 350, 0.4, 0.371428571429, 130, 171, 179
5, 400, 0.44, 0.38, 152, 191, 209
5, 450, 0.38, 0.38, 171, 207, 243
5, 500, 0.46, 0.388, 194, 211, 289
5, 550, 0.3, 0.38, 209, 218, 332
5, 600, 0.36, 0.378333333333, 227, 223, 377
5, 650, 0.32, 0.373846153846, 243, 228, 422
5, 700, 0.4, 0.375714285714, 263, 231, 469
5, 750, 0.46, 0.381333333333, 286, 234, 516
5, 800, 0.44, 0.385, 308, 238, 562
5, 850, 0.36, 0.383529411765, 326, 245, 605
5, 900, 0.26, 0.376666666667, 339, 254, 646
5, 950, 0.3, 0.372631578947, 354, 264, 686
5, 1000, 0.5, 0.379, 379, 275, 725
5, 1050, 0.52, 0.385714285714, 405, 285, 765
5, 1100, 0.44, 0.388181818182, 427, 293, 807
5, 1150, 0.38, 0.387826086957, 446, 302, 848
5, 1200, 0.4, 0.388333333333, 466, 313, 887
5, 1250, 0.4, 0.3888, 486, 319, 931
5, 1300, 0.36, 0.387692307692, 504, 331, 969
5, 1350, 0.5, 0.391851851852, 529, 345, 1005
5, 1400, 0.4, 0.392142857143, 549, 361, 1039
5, 1450, 0.42, 0.393103448276, 570, 378, 1072
5, 1500, 0.34, 0.391333333333, 587, 396, 1104
5, 1550, 0.38, 0.390967741935, 606, 408, 1142
5, 1600, 0.3, 0.388125, 621, 422, 1178
5, 1650, 0.38, 0.387878787879, 640, 443, 1207
5, 1700, 0.42, 0.388823529412, 661, 462, 1238
5, 1750, 0.32, 0.386857142857, 677, 481, 1269
5, 1800, 0.34, 0.385555555556, 694, 502, 1298
5, 1850, 0.32, 0.383783783784, 710, 519, 1331
5, 1900, 0.46, 0.385789473684, 733, 528, 1372
5, 1950, 0.4, 0.386153846154, 753, 547, 1403
5, 2000, 0.34, 0.385, 770, 562, 1438
6, 50, 0.3, 0.3, 15, 30, 20
6, 100, 0.26, 0.28, 28, 53, 47
6, 150, 0.44, 0.333333333333, 50, 79, 71
6, 200, 0.38, 0.345, 69, 102, 98
6, 250, 0.56, 0.388, 97, 133, 117
6, 300, 0.34, 0.38, 114, 163, 137
6, 350, 0.38, 0.38, 133, 190, 160
6, 400, 0.34, 0.375, 150, 214, 186
6, 450, 0.32, 0.368888888889, 166, 233, 217
6, 500, 0.46, 0.378, 189, 240, 260
6, 550, 0.34, 0.374545454545, 206, 246, 304
6, 600, 0.36, 0.373333333333, 224, 263, 337
6, 650, 0.36, 0.372307692308, 242, 283, 367
6, 700, 0.36, 0.371428571429, 260, 306, 394
6, 750, 0.48, 0.378666666667, 284, 330, 420
6, 800, 0.44, 0.3825, 306, 364, 436
6, 850, 0.3, 0.377647058824, 321, 389, 461
6, 900, 0.3, 0.373333333333, 336, 412, 488
6, 950, 0.46, 0.377894736842, 359, 431, 519
6, 1000, 0.36, 0.377, 377, 459, 541
6, 1050, 0.4, 0.378095238095, 397, 476, 574
6, 1100, 0.36, 0.377272727273, 415, 495, 605
6, 1150, 0.3, 0.373913043478, 430, 511, 639
6, 1200, 0.44, 0.376666666667, 452, 530, 670
6, 1250, 0.42, 0.3784, 473, 542, 708
6, 1300, 0.48, 0.382307692308, 497, 547, 753
6, 1350, 0.4, 0.382962962963, 517, 549, 801
6, 1400, 0.38, 0.382857142857, 536, 554, 846
6, 1450, 0.32, 0.380689655172, 552, 563, 887
6, 1500, 0.56, 0.386666666667, 580, 566, 934
6, 1550, 0.4, 0.387096774194, 600, 567, 983
6, 1600, 0.5, 0.390625, 625, 567, 1033
6, 1650, 0.34, 0.389090909091, 642, 568, 1082
6, 1700, 0.2, 0.383529411765, 652, 572, 1128
6, 1750, 0.2, 0.378285714286, 662, 572, 1178
6, 1800, 0.5, 0.381666666667, 687, 575, 1225
6, 1850, 0.36, 0.381081081081, 705, 578, 1272
6, 1900, 0.4, 0.381578947368, 725, 579, 1321
6, 1950, 0.38, 0.381538461538, 744, 580, 1370
6, 2000, 0.2, 0.377, 754, 582, 1418
7, 50, 0.32, 0.32, 16, 28, 22
7, 100, 0.34, 0.33, 33, 48, 52
7, 150, 0.34, 0.333333333333, 50, 76, 74
7, 200, 0.46, 0.365, 73, 97, 103
7, 250, 0.36, 0.364, 91, 118, 132
7, 300, 0.4, 0.37, 111, 141, 159
7, 350, 0.44, 0.38, 133, 162, 188
7, 400, 0.54, 0.4, 160, 190, 210
7, 450, 0.28, 0.386666666667, 174, 228, 222
7, 500, 0.48, 0.396, 198, 273, 227
7, 550, 0.36, 0.392727272727, 216, 320, 230
7, 600, 0.28, 0.383333333333, 230, 363, 237
7, 650, 0.34, 0.38, 247, 407, 243
7, 700, 0.44, 0.384285714286, 269, 445, 255
7, 750, 0.36, 0.382666666667, 287, 481, 269
7, 800, 0.32, 0.37875, 303, 512, 288
7, 850, 0.44, 0.382352941176, 325, 539, 311
7, 900, 0.24, 0.374444444444, 337, 558, 342
7, 950, 0.12, 0.361052631579, 343, 587, 363
7, 1000, 0.28, 0.357, 357, 611, 389
7, 1050, 0.42, 0.36, 378, 626, 424
7, 1100, 0.3, 0.357272727273, 393, 652, 448
7, 1150, 0.32, 0.355652173913, 409, 681, 469
7, 1200, 0.38, 0.356666666667, 428, 708, 492
7, 1250, 0.3, 0.3544, 443, 731, 519
7, 1300, 0.34, 0.353846153846, 460, 761, 539
7, 1350, 0.4, 0.355555555556, 480, 788, 562
7, 1400, 0.42, 0.357857142857, 501, 806, 594
7, 1450, 0.42, 0.36, 522, 830, 620
7, 1500, 0.4, 0.361333333333, 542, 853, 647
7, 1550, 0.4, 0.362580645161, 562, 873, 677
7, 1600, 0.44, 0.365, 584, 889, 711
7, 1650, 0.38, 0.365454545455, 603, 906, 744
7, 1700, 0.52, 0.37, 629, 924, 776
7, 1750, 0.4, 0.370857142857, 649, 933, 817
7, 1800, 0.5, 0.374444444444, 674, 949, 851
7, 1850, 0.5, 0.377837837838, 699, 956, 894
7, 1900, 0.34, 0.376842105263, 716, 959, 941
7, 1950, 0.32, 0.375384615385, 732, 968, 982
7, 2000, 0.34, 0.3745, 749, 979, 1021
8, 50, 0.44, 0.44, 22, 23, 27
8, 100, 0.3, 0.37, 37, 48, 52
8, 150, 0.22, 0.32, 48, 75, 75
8, 200, 0.4, 0.34, 68, 101, 99
8, 250, 0.32, 0.336, 84, 129, 121
8, 300, 0.24, 0.32, 96, 162, 138
8, 350, 0.5, 0.345714285714, 121, 185, 165
8, 400, 0.34, 0.345, 138, 211, 189
8, 450, 0.46, 0.357777777778, 161, 244, 206
8, 500, 0.36, 0.358, 179, 277, 223
8, 550, 0.36, 0.358181818182, 197, 318, 232
8, 600, 0.34, 0.356666666667, 214, 355, 245
8, 650, 0.34, 0.355384615385, 231, 388, 262
8, 700, 0.44, 0.361428571429, 253, 424, 276
8, 750, 0.44, 0.366666666667, 275, 465, 285
8, 800, 0.3, 0.3625, 290, 504, 296
8, 850, 0.3, 0.358823529412, 305, 543, 307
8, 900, 0.26, 0.353333333333, 318, 581, 319
8, 950, 0.44, 0.357894736842, 340, 623, 327
8, 1000, 0.42, 0.361, 361, 658, 342
8, 1050, 0.34, 0.36, 378, 694, 356
8, 1100, 0.42, 0.362727272727, 399, 731, 369
8, 1150, 0.36, 0.362608695652, 417, 768, 382
8, 1200, 0.32, 0.360833333333, 433, 804, 396
8, 1250, 0.4, 0.3624, 453, 841, 409
8, 1300, 0.44, 0.365384615385, 475, 873, 427
8, 1350, 0.3, 0.362962962963, 490, 913, 437
8, 1400, 0.36, 0.362857142857, 508, 955, 445
8, 1450, 0.32, 0.361379310345, 524, 998, 452
8, 1500, 0.56, 0.368, 552, 1036, 464
8, 1550, 0.38, 0.368387096774, 571, 1082, 468
8, 1600, 0.3, 0.36625, 586, 1130, 470
8, 1650, 0.3, 0.364242424242, 601, 1175, 475
8, 1700, 0.46, 0.367058823529, 624, 1217, 483
8, 1750, 0.38, 0.367428571429, 643, 1260, 490
8, 1800, 0.42, 0.368888888889, 664, 1305, 495
8, 1850, 0.38, 0.369189189189, 683, 1352, 498
8, 1900, 0.3, 0.367368421053, 698, 1401, 499
8, 1950, 0.38, 0.367692307692, 717, 1447, 503
8, 2000, 0.36, 0.3675, 735, 1494, 506
9, 50, 0.5, 0.5, 25, 28, 22
9, 100, 0.32, 0.41, 41, 59, 41
9, 150, 0.36, 0.393333333333, 59, 80, 70
9, 200, 0.42, 0.4, 80, 101, 99
9, 250, 0.32, 0.384, 96, 131, 119
9, 300, 0.32, 0.373333333333, 112, 160, 140
9, 350, 0.46, 0.385714285714, 135, 187, 163
9, 400, 0.34, 0.38, 152, 204, 196
9, 450, 0.36, 0.377777777778, 170, 213, 237
9, 500, 0.32, 0.372, 186, 217, 283
9, 550, 0.48, 0.381818181818, 210, 228, 322
9, 600, 0.38, 0.381666666667, 229, 232, 368
9, 650, 0.38, 0.381538461538, 248, 248, 402
9, 700, 0.5, 0.39, 273, 272, 428
9, 750, 0.42, 0.392, 294, 292, 458
9, 800, 0.32, 0.3875, 310, 306, 494
9, 850, 0.36, 0.385882352941, 328, 314, 536
9, 900, 0.4, 0.386666666667, 348, 323, 577
9, 950, 0.32, 0.383157894737, 364, 329, 621
9, 1000, 0.44, 0.386, 386, 333, 667
9, 1050, 0.36, 0.384761904762, 404, 341, 709
9, 1100, 0.36, 0.383636363636, 422, 344, 756
9, 1150, 0.44, 0.386086956522, 444, 346, 804
9, 1200, 0.42, 0.3875, 465, 348, 852
9, 1250, 0.38, 0.3872, 484, 351, 899
9, 1300, 0.44, 0.389230769231, 506, 354, 946
9, 1350, 0.38, 0.388888888889, 525, 355, 995
9, 1400, 0.28, 0.385, 539, 359, 1041
9, 1450, 0.44, 0.386896551724, 561, 361, 1089
9, 1500, 0.42, 0.388, 582, 366, 1134
9, 1550, 0.34, 0.386451612903, 599, 368, 1182
9, 1600, 0.44, 0.388125, 621, 378, 1222
9, 1650, 0.38, 0.387878787879, 640, 385, 1265
9, 1700, 0.28, 0.384705882353, 654, 396, 1304
9, 1750, 0.44, 0.386285714286, 676, 401, 1349
9, 1800, 0.24, 0.382222222222, 688, 403, 1397
9, 1850, 0.46, 0.384324324324, 711, 409, 1441
9, 1900, 0.34, 0.383157894737, 728, 413, 1487
9, 1950, 0.28, 0.380512820513, 742, 414, 1536
9, 2000, 0.32, 0.379, 758, 415, 1585
10, 50, 0.38, 0.38, 19, 23, 27
10, 100, 0.4, 0.39, 39, 52, 48
10, 150, 0.38, 0.386666666667, 58, 80, 70
10, 200, 0.3, 0.365, 73, 113, 87
10, 250, 0.44, 0.38, 95, 139, 111
10, 300, 0.34, 0.373333333333, 112, 170, 130
10, 350, 0.46, 0.385714285714, 135, 198, 152
10, 400, 0.4, 0.3875, 155, 221, 179
10, 450, 0.38, 0.386666666667, 174, 250, 200
10, 500, 0.52, 0.4, 200, 288, 212
10, 550, 0.3, 0.390909090909, 215, 323, 227
10, 600, 0.48, 0.398333333333, 239, 369, 231
10, 650, 0.38, 0.396923076923, 258, 417, 233
10, 700, 0.36, 0.394285714286, 276, 465, 235
10, 750, 0.36, 0.392, 294, 507, 243
10, 800, 0.54, 0.40125, 321, 549, 251
10, 850, 0.38, 0.4, 340, 588, 262
10, 900, 0.4, 0.4, 360, 631, 269
10, 950, 0.4, 0.4, 380, 673, 277
10, 1000, 0.3, 0.395, 395, 719, 281
10, 1050, 0.32, 0.391428571429, 411, 759, 291
10, 1100, 0.34, 0.389090909091, 428, 800, 300
10, 1150, 0.3, 0.385217391304, 443, 843, 307
10, 1200, 0.48, 0.389166666667, 467, 889, 311
10, 1250, 0.32, 0.3864, 483, 933, 317
10, 1300, 0.36, 0.385384615385, 501, 977, 323
10, 1350, 0.32, 0.382962962963, 517, 1013, 337
10, 1400, 0.32, 0.380714285714, 533, 1056, 344
10, 1450, 0.34, 0.379310344828, 550, 1092, 358
10, 1500, 0.34, 0.378, 567, 1127, 373
10, 1550, 0.44, 0.38, 589, 1156, 394
10, 1600, 0.26, 0.37625, 602, 1184, 416
10, 1650, 0.46, 0.378787878788, 625, 1206, 444
10, 1700, 0.3, 0.376470588235, 640, 1233, 467
10, 1750, 0.46, 0.378857142857, 663, 1255, 495
10, 1800, 0.28, 0.376111111111, 677, 1279, 521
10, 1850, 0.32, 0.374594594595, 693, 1298, 552
10, 1900, 0.36, 0.374210526316, 711, 1321, 579
10, 1950, 0.34, 0.373333333333, 728, 1341, 609
10, 2000, 0.4, 0.374, 748, 1351, 649
11, 50, 0.32, 0.32, 16, 24, 26
11, 100, 0.28, 0.3, 30, 50, 50
11, 150, 0.5, 0.366666666667, 55, 71, 79
11, 200, 0.4, 0.375, 75, 93, 107
11, 250, 0.26, 0.352, 88, 118, 132
11, 300, 0.34, 0.35, 105, 136, 164
11, 350, 0.46, 0.365714285714, 128, 154, 196
11, 400, 0.26, 0.3525, 141, 178, 222
11, 450, 0.5, 0.368888888889, 166, 203, 247
11, 500, 0.38, 0.37, 185, 213, 287
11, 550, 0.44, 0.376363636364, 207, 220, 330
11, 600, 0.28, 0.368333333333, 221, 222, 378
11, 650, 0.42, 0.372307692308, 242, 226, 424
11, 700, 0.3, 0.367142857143, 257, 229, 471
11, 750, 0.38, 0.368, 276, 233, 517
11, 800, 0.34, 0.36625, 293, 233, 567
11, 850, 0.42, 0.369411764706, 314, 237, 613
11, 900, 0.3, 0.365555555556, 329, 243, 657
11, 950, 0.34, 0.364210526316, 346, 254, 696
11, 1000, 0.48, 0.37, 370, 264, 736
11, 1050, 0.44, 0.373333333333, 392, 270, 780
11, 1100, 0.4, 0.374545454545, 412, 273, 827
11, 1150, 0.38, 0.374782608696, 431, 277, 873
11, 1200, 0.28, 0.370833333333, 445, 280, 920
11, 1250, 0.28, 0.3672, 459, 284, 966
11, 1300, 0.34, 0.366153846154, 476, 290, 1010
11, 1350, 0.3, 0.363703703704, 491, 296, 1054
11, 1400, 0.4, 0.365, 511, 299, 1101
11, 1450, 0.38, 0.365517241379, 530, 303, 1147
11, 1500, 0.44, 0.368, 552, 308, 1192
11, 1550, 0.44, 0.370322580645, 574, 313, 1237
11, 1600, 0.4, 0.37125, 594, 319, 1281
11, 1650, 0.36, 0.370909090909, 612, 323, 1327
11, 1700, 0.34, 0.37, 629, 332, 1368
11, 1750, 0.38, 0.370285714286, 648, 336, 1414
11, 1800, 0.52, 0.374444444444, 674, 340, 1460
11, 1850, 0.4, 0.375135135135, 694, 342, 1508
11, 1900, 0.4, 0.375789473684, 714, 346, 1554
11, 1950, 0.34, 0.374871794872, 731, 349, 1601
11, 2000, 0.44, 0.3765, 753, 352, 1648
12, 50, 0.32, 0.32, 16, 20, 30
12, 100, 0.4, 0.36, 36, 45, 55
12, 150, 0.44, 0.386666666667, 58, 70, 80
12, 200, 0.36, 0.38, 76, 91, 109
12, 250, 0.2, 0.344, 86, 111, 139
12, 300, 0.4, 0.353333333333, 106, 142, 158
12, 350, 0.44, 0.365714285714, 128, 174, 176
12, 400, 0.5, 0.3825, 153, 200, 200
12, 450, 0.42, 0.386666666667, 174, 221, 229
12, 500, 0.4, 0.388, 194, 250, 250
12, 550, 0.22, 0.372727272727, 205, 281, 269
12, 600, 0.5, 0.383333333333, 230, 306, 294
12, 650, 0.32, 0.378461538462, 246, 318, 332
12, 700, 0.34, 0.375714285714, 263, 334, 366
12, 750, 0.42, 0.378666666667, 284, 355, 395
12, 800, 0.44, 0.3825, 306, 374, 426
12, 850, 0.42, 0.384705882353, 327, 400, 450
12, 900, 0.38, 0.384444444444, 346, 423, 477
12, 950, 0.22, 0.375789473684, 357, 444, 506
12, 1000, 0.32, 0.373, 373, 475, 525
12, 1050, 0.3, 0.369523809524, 388, 499, 551
12, 1100, 0.5, 0.375454545455, 413, 527, 573
12, 1150, 0.38, 0.375652173913, 432, 562, 588
12, 1200, 0.3, 0.3725, 447, 597, 603
12, 1250, 0.44, 0.3752, 469, 623, 627
12, 1300, 0.34, 0.373846153846, 486, 650, 650
12, 1350, 0.46, 0.377037037037, 509, 674, 676
12, 1400, 0.44, 0.379285714286, 531, 700, 700
12, 1450, 0.44, 0.381379310345, 553, 721, 729
12, 1500, 0.4, 0.382, 573, 749, 751
12, 1550, 0.4, 0.382580645161, 593, 771, 779
12, 1600, 0.44, 0.384375, 615, 800, 800
12, 1650, 0.38, 0.384242424242, 634, 826, 824
12, 1700, 0.28, 0.381176470588, 648, 849, 851
12, 1750, 0.36, 0.380571428571, 666, 868, 882
12, 1800, 0.52, 0.384444444444, 692, 890, 910
12, 1850, 0.42, 0.385405405405, 713, 915, 935
12, 1900, 0.42, 0.386315789474, 734, 934, 966
12, 1950, 0.36, 0.385641025641, 752, 955, 995
12, 2000, 0.32, 0.384, 768, 978, 1022
13, 50, 0.34, 0.34, 17, 31, 19
13, 100, 0.36, 0.35, 35, 55, 45
13, 150, 0.24, 0.313333333333, 47, 83, 67
13, 200, 0.34, 0.32, 64, 103, 97
13, 250, 0.36, 0.328, 82, 131, 119
13, 300, 0.32, 0.326666666667, 98, 163, 137
13, 350, 0.38, 0.334285714286, 117, 180, 170
13, 400, 0.36, 0.3375, 135, 203, 197
13, 450, 0.32, 0.335555555556, 151, 213, 237
13, 500, 0.32, 0.334, 167, 221, 279
13, 550, 0.38, 0.338181818182, 186, 232, 318
13, 600, 0.34, 0.338333333333, 203, 238, 362
13, 650, 0.38, 0.341538461538, 222, 244, 406
13, 700, 0.34, 0.341428571429, 239, 248, 452
13, 750, 0.48, 0.350666666667, 263, 248, 502
13, 800, 0.38, 0.3525, 282, 251, 549
13, 850, 0.34, 0.351764705882, 299, 254, 596
13, 900, 0.38, 0.353333333333, 318, 257, 643
13, 950, 0.36, 0.353684210526, 336, 260, 690
13, 1000, 0.46, 0.359, 359, 265, 735
13, 1050, 0.3, 0.35619047619, 374, 266, 784
13, 1100, 0.34, 0.355454545455, 391, 271, 829
13, 1150, 0.44, 0.359130434783, 413, 271, 879
13, 1200, 0.36, 0.359166666667, 431, 273, 927
13, 1250, 0.44, 0.3624, 453, 274, 976
13, 1300, 0.42, 0.364615384615, 474, 275, 1025
13, 1350, 0.44, 0.367407407407, 496, 275, 1075
13, 1400, 0.34, 0.366428571429, 513, 278, 1122
13, 1450, 0.48, 0.370344827586, 537, 280, 1170
13, 1500, 0.46, 0.373333333333, 560, 281, 1219
13, 1550, 0.4, 0.374193548387, 580, 281, 1269
13, 1600, 0.38, 0.374375, 599, 282, 1318
13, 1650, 0.4, 0.375151515152, 619, 282, 1368
13, 1700, 0.44, 0.377058823529, 641, 282, 1418
13, 1750, 0.38, 0.377142857143, 660, 283, 1467
13, 1800, 0.38, 0.377222222222, 679, 283, 1517
13, 1850, 0.42, 0.378378378378, 700, 283, 1567
13, 1900, 0.36, 0.377894736842, 718, 285, 1615
13, 1950, 0.4, 0.378461538462, 738, 285, 1665
13, 2000, 0.4, 0.379, 758, 287, 1713
14, 50, 0.38, 0.38, 19, 27, 23
14, 100, 0.36, 0.37, 37, 42, 58
14, 150, 0.44, 0.393333333333, 59, 73, 77
14, 200, 0.36, 0.385, 77, 97, 103
14, 250, 0.46, 0.4, 100, 124, 126
14, 300, 0.4, 0.4, 120, 148, 152
14, 350, 0.38, 0.397142857143, 139, 180, 170
14, 400, 0.42, 0.4, 160, 208, 192
14, 450, 0.46, 0.406666666667, 183, 240, 210
14, 500, 0.42, 0.408, 204, 279, 221
14, 550, 0.36, 0.403636363636, 222, 315, 235
14, 600, 0.28, 0.393333333333, 236, 359, 241
14, 650, 0.38, 0.392307692308, 255, 394, 256
14, 700, 0.36, 0.39, 273, 437, 263
14, 750, 0.34, 0.386666666667, 290, 474, 276
14, 800, 0.38, 0.38625, 309, 505, 295
14, 850, 0.4, 0.387058823529, 329, 535, 315
14, 900, 0.34, 0.384444444444, 346, 564, 336
14, 950, 0.46, 0.388421052632, 369, 596, 354
14, 1000, 0.36, 0.387, 387, 617, 383
14, 1050, 0.4, 0.387619047619, 407, 637, 413
14, 1100, 0.4, 0.388181818182, 427, 654, 446
14, 1150, 0.4, 0.388695652174, 447, 686, 464
14, 1200, 0.32, 0.385833333333, 463, 707, 493
14, 1250, 0.34, 0.384, 480, 733, 517
14, 1300, 0.4, 0.384615384615, 500, 754, 546
14, 1350, 0.34, 0.382962962963, 517, 784, 566
14, 1400, 0.38, 0.382857142857, 536, 812, 588
14, 1450, 0.34, 0.381379310345, 553, 834, 616
14, 1500, 0.4, 0.382, 573, 858, 642
14, 1550, 0.38, 0.381935483871, 592, 880, 670
14, 1600, 0.32, 0.38, 608, 900, 700
14, 1650, 0.38, 0.38, 627, 932, 718
14, 1700, 0.34, 0.378823529412, 644, 958, 742
14, 1750, 0.28, 0.376, 658, 990, 760
14, 1800, 0.34, 0.375, 675, 1020, 780
14, 1850, 0.38, 0.375135135135, 694, 1046, 804
14, 1900, 0.34, 0.374210526316, 711, 1067, 833
14, 1950, 0.46, 0.37641025641, 734, 1086, 864
14, 2000, 0.38, 0.3765, 753, 1099, 901
15, 50, 0.42, 0.42, 21, 19, 31
15, 100, 0.4, 0.41, 41, 46, 54
15, 150, 0.36, 0.393333333333, 59, 65, 85
15, 200, 0.38, 0.39, 78, 91, 109
15, 250, 0.28, 0.368, 92, 107, 143
15, 300, 0.46, 0.383333333333, 115, 134, 166
15, 350, 0.32, 0.374285714286, 131, 154, 196
15, 400, 0.42, 0.38, 152, 190, 210
15, 450, 0.5, 0.393333333333, 177, 225, 225
15, 500, 0.42, 0.396, 198, 265, 235
15, 550, 0.4, 0.396363636364, 218, 304, 246
15, 600, 0.46, 0.401666666667, 241, 351, 249
15, 650, 0.4, 0.401538461538, 261, 395, 255
15, 700, 0.34, 0.397142857143, 278, 442, 258
15, 750, 0.2, 0.384, 288, 485, 265
15, 800, 0.42, 0.38625, 309, 523, 277
15, 850, 0.36, 0.384705882353, 327, 563, 287
15, 900, 0.38, 0.384444444444, 346, 601, 299
15, 950, 0.36, 0.383157894737, 364, 643, 307
15, 1000, 0.34, 0.381, 381, 685, 315
15, 1050, 0.4, 0.381904761905, 401, 722, 328
15, 1100, 0.38, 0.381818181818, 420, 761, 339
15, 1150, 0.4, 0.382608695652, 440, 802, 348
15, 1200, 0.44, 0.385, 462, 834, 366
15, 1250, 0.34, 0.3832, 479, 881, 369
15, 1300, 0.32, 0.380769230769, 495, 921, 379
15, 1350, 0.32, 0.378518518519, 511, 961, 389
15, 1400, 0.5, 0.382857142857, 536, 1008, 392
15, 1450, 0.36, 0.382068965517, 554, 1050, 400
15, 1500, 0.36, 0.381333333333, 572, 1093, 407
15, 1550, 0.44, 0.383225806452, 594, 1140, 410
15, 1600, 0.38, 0.383125, 613, 1189, 411
15, 1650, 0.44, 0.384848484848, 635, 1234, 416
15, 1700, 0.38, 0.384705882353, 654, 1281, 419
15, 1750, 0.36, 0.384, 672, 1329, 421
15, 1800, 0.42, 0.385, 693, 1373, 427
15, 1850, 0.42, 0.385945945946, 714, 1421, 429
15, 1900, 0.42, 0.386842105263, 735, 1469, 431
15, 1950, 0.42, 0.387692307692, 756, 1515, 435
15, 2000, 0.36, 0.387, 774, 1557, 443
16, 50, 0.44, 0.44, 22, 24, 26
16, 100, 0.24, 0.34, 34, 50, 50
16, 150, 0.46, 0.38, 57, 72, 78
16, 200, 0.38, 0.38, 76, 97, 103
16, 250, 0.22, 0.348, 87, 125, 125
16, 300, 0.4, 0.356666666667, 107, 150, 150
16, 350, 0.22, 0.337142857143, 118, 174, 176
16, 400, 0.36, 0.34, 136, 197, 203
16, 450, 0.38, 0.344444444444, 155, 216, 234
16, 500, 0.38, 0.348, 174, 230, 270
16, 550, 0.36, 0.349090909091, 192, 241, 309
16, 600, 0.36, 0.35, 210, 256, 344
16, 650, 0.42, 0.355384615385, 231, 259, 391
16, 700, 0.32, 0.352857142857, 247, 266, 434
16, 750, 0.36, 0.353333333333, 265, 269, 481
16, 800, 0.56, 0.36625, 293, 269, 531
16, 850, 0.44, 0.370588235294, 315, 269, 581
16, 900, 0.3, 0.366666666667, 330, 269, 631
16, 950, 0.38, 0.367368421053, 349, 270, 680
16, 1000, 0.42, 0.37, 370, 272, 728
16, 1050, 0.42, 0.372380952381, 391, 274, 776
16, 1100, 0.4, 0.373636363636, 411, 276, 824
16, 1150, 0.42, 0.375652173913, 432, 277, 873
16, 1200, 0.38, 0.375833333333, 451, 277, 923
16, 1250, 0.42, 0.3776, 472, 279, 971
16, 1300, 0.4, 0.378461538462, 492, 279, 1021
16, 1350, 0.38, 0.378518518519, 511, 282, 1068
16, 1400, 0.44, 0.380714285714, 533, 283, 1117
16, 1450, 0.44, 0.38275862069, 555, 284, 1166
16, 1500, 0.28, 0.379333333333, 569, 285, 1215
16, 1550, 0.36, 0.378709677419, 587, 286, 1264
16, 1600, 0.32, 0.376875, 603, 288, 1312
16, 1650, 0.42, 0.378181818182, 624, 290, 1360
16, 1700, 0.44, 0.38, 646, 291, 1409
16, 1750, 0.44, 0.381714285714, 668, 293, 1457
16, 1800, 0.36, 0.381111111111, 686, 294, 1506
16, 1850, 0.38, 0.381081081081, 705, 296, 1554
16, 1900, 0.42, 0.382105263158, 726, 298, 1602
16, 1950, 0.34, 0.381025641026, 743, 299, 1651
16, 2000, 0.36, 0.3805, 761, 299, 1701
17, 50, 0.4, 0.4, 20, 35, 15
17, 100, 0.24, 0.32, 32, 61, 39
17, 150, 0.4, 0.346666666667, 52, 79, 71
17, 200, 0.3, 0.335, 67, 105, 95
17, 250, 0.38, 0.344, 86, 129, 121
17, 300, 0.44, 0.36, 108, 152, 148
17, 350, 0.5, 0.38, 133, 171, 179
17, 400, 0.4, 0.3825, 153, 194, 206
17, 450, 0.46, 0.391111111111, 176, 224, 226
17, 500, 0.26, 0.378, 189, 249, 251
17, 550, 0.32, 0.372727272727, 205, 265, 285
17, 600, 0.34, 0.37, 222, 291, 309
17, 650, 0.5, 0.38, 247, 317, 333
17, 700, 0.3, 0.374285714286, 262, 350, 350
17, 750, 0.36, 0.373333333333, 280, 388, 362
17, 800, 0.4, 0.375, 300, 415, 385
17, 850, 0.46, 0.38, 323, 455, 395
17, 900, 0.32, 0.376666666667, 339, 489, 411
17, 950, 0.58, 0.387368421053, 368, 523, 427
17, 1000, 0.34, 0.385, 385, 553, 447
17, 1050, 0.4, 0.385714285714, 405, 584, 466
17, 1100, 0.42, 0.387272727273, 426, 625, 475
17, 1150, 0.34, 0.385217391304, 443, 658, 492
17, 1200, 0.34, 0.383333333333, 460, 686, 514
17, 1250, 0.26, 0.3784, 473, 708, 542
17, 1300, 0.4, 0.379230769231, 493, 731, 569
17, 1350, 0.3, 0.376296296296, 508, 754, 596
17, 1400, 0.44, 0.378571428571, 530, 776, 624
17, 1450, 0.18, 0.371724137931, 539, 800, 650
17, 1500, 0.44, 0.374, 561, 822, 678
17, 1550, 0.34, 0.372903225806, 578, 842, 708
17, 1600, 0.46, 0.375625, 601, 862, 738
17, 1650, 0.5, 0.379393939394, 626, 881, 769
17, 1700, 0.5, 0.382941176471, 651, 908, 792
17, 1750, 0.3, 0.380571428571, 666, 925, 825
17, 1800, 0.44, 0.382222222222, 688, 932, 868
17, 1850, 0.32, 0.380540540541, 704, 941, 909
17, 1900, 0.26, 0.377368421053, 717, 953, 947
17, 1950, 0.44, 0.378974358974, 739, 962, 988
17, 2000, 0.44, 0.3805, 761, 972, 1028
18, 50, 0.4, 0.4, 20, 21, 29
18, 100, 0.44, 0.42, 42, 45, 55
18, 150, 0.38, 0.406666666667, 61, 69, 81
18, 200, 0.2, 0.355, 71, 95, 105
18, 250, 0.28, 0.34, 85, 119, 131
18, 300, 0.5, 0.366666666667, 110, 146, 154
18, 350, 0.44, 0.377142857143, 132, 174, 176
18, 400, 0.4, 0.38, 152, 200, 200
18, 450, 0.3, 0.371111111111, 167, 206, 244
18, 500, 0.3, 0.364, 182, 214, 286
18, 550, 0.38, 0.365454545455, 201, 216, 334
18, 600, 0.46, 0.373333333333, 224, 224, 376
18, 650, 0.42, 0.376923076923, 245, 229, 421
18, 700, 0.34, 0.374285714286, 262, 234, 466
18, 750, 0.38, 0.374666666667, 281, 240, 510
18, 800, 0.44, 0.37875, 303, 243, 557
18, 850, 0.42, 0.381176470588, 324, 244, 606
18, 900, 0.34, 0.378888888889, 341, 247, 653
18, 950, 0.52, 0.386315789474, 367, 258, 692
18, 1000, 0.24, 0.379, 379, 261, 739
18, 1050, 0.3, 0.375238095238, 394, 265, 785
18, 1100, 0.54, 0.382727272727, 421, 270, 830
18, 1150, 0.48, 0.386956521739, 445, 274, 876
18, 1200, 0.4, 0.3875, 465, 275, 925
18, 1250, 0.28, 0.3832, 479, 277, 973
18, 1300, 0.38, 0.383076923077, 498, 282, 1018
18, 1350, 0.26, 0.378518518519, 511, 287, 1063
18, 1400, 0.42, 0.38, 532, 291, 1109
18, 1450, 0.44, 0.382068965517, 554, 293, 1157
18, 1500, 0.32, 0.38, 570, 298, 1202
18, 1550, 0.52, 0.384516129032, 596, 301, 1249
18, 1600, 0.4, 0.385, 616, 304, 1296
18, 1650, 0.36, 0.384242424242, 634, 305, 1345
18, 1700, 0.34, 0.382941176471, 651, 307, 1393
18, 1750, 0.46, 0.385142857143, 674, 308, 1442
18, 1800, 0.56, 0.39, 702, 309, 1491
18, 1850, 0.38, 0.38972972973, 721, 312, 1538
18, 1900, 0.38, 0.389473684211, 740, 313, 1587
18, 1950, 0.4, 0.389743589744, 760, 315, 1635
18, 2000, 0.56, 0.394, 788, 315, 1685
19, 50, 0.3, 0.3, 15, 25, 25
19, 100, 0.36, 0.33, 33, 47, 53
19, 150, 0.38, 0.346666666667, 52, 76, 74
19, 200, 0.4, 0.36, 72, 99, 101
19, 250, 0.54, 0.396, 99, 122, 128
19, 300, 0.3, 0.38, 114, 148, 152
19, 350, 0.46, 0.391428571429, 137, 175, 175
19, 400, 0.34, 0.385, 154, 190, 210
19, 450, 0.48, 0.395555555556, 178, 206, 244
19, 500, 0.4, 0.396, 198, 212, 288
19, 550, 0.36, 0.392727272727, 216, 216, 334
19, 600, 0.42, 0.395, 237, 219, 381
19, 650, 0.4, 0.395384615385, 257, 221, 429
19, 700, 0.38, 0.394285714286, 276, 226, 474
19, 750, 0.42, 0.396, 297, 226, 524
19, 800, 0.4, 0.39625, 317, 227, 573
19, 850, 0.34, 0.392941176471, 334, 227, 623
19, 900, 0.46, 0.396666666667, 357, 230, 670
19, 950, 0.3, 0.391578947368, 372, 231, 719
19, 1000, 0.32, 0.388, 388, 232, 768
19, 1050, 0.52, 0.394285714286, 414, 236, 814
19, 1100, 0.52, 0.4, 440, 236, 864
19, 1150, 0.28, 0.394782608696, 454, 236, 914
19, 1200, 0.36, 0.393333333333, 472, 236, 964
19, 1250, 0.42, 0.3944, 493, 239, 1011
19, 1300, 0.4, 0.394615384615, 513, 239, 1061
19, 1350, 0.44, 0.396296296296, 535, 240, 1110
19, 1400, 0.46, 0.398571428571, 558, 241, 1159
19, 1450, 0.36, 0.39724137931, 576, 243, 1207
19, 1500, 0.32, 0.394666666667, 592, 245, 1255
19, 1550, 0.4, 0.394838709677, 612, 245, 1305
19, 1600, 0.36, 0.39375, 630, 245, 1355
19, 1650, 0.42, 0.394545454545, 651, 246, 1404
19, 1700, 0.3, 0.391764705882, 666, 247, 1453
19, 1750, 0.5, 0.394857142857, 691, 247, 1503
19, 1800, 0.44, 0.396111111111, 713, 247, 1553
19, 1850, 0.36, 0.395135135135, 731, 248, 1602
19, 1900, 0.38, 0.394736842105, 750, 248, 1652
19, 1950, 0.5, 0.397435897436, 775, 249, 1701
19, 2000, 0.28, 0.3945, 789, 250, 1750
20, 50, 0.46, 0.46, 23, 25, 25
20, 100, 0.42, 0.44, 44, 52, 48
20, 150, 0.46, 0.446666666667, 67, 80, 70
20, 200, 0.34, 0.42, 84, 104, 96
20, 250, 0.4, 0.416, 104, 127, 123
20, 300, 0.4, 0.413333333333, 124, 152, 148
20, 350, 0.22, 0.385714285714, 135, 175, 175
20, 400, 0.46, 0.395, 158, 199, 201
20, 450, 0.32, 0.386666666667, 174, 214, 236
20, 500, 0.38, 0.386, 193, 219, 281
20, 550, 0.46, 0.392727272727, 216, 224, 326
20, 600, 0.44, 0.396666666667, 238, 227, 373
20, 650, 0.4, 0.396923076923, 258, 229, 421
20, 700, 0.3, 0.39, 273, 230, 470
20, 750, 0.44, 0.393333333333, 295, 235, 515
20, 800, 0.46, 0.3975, 318, 237, 563
20, 850, 0.34, 0.394117647059, 335, 240, 610
20, 900, 0.4, 0.394444444444, 355, 241, 659
20, 950, 0.36, 0.392631578947, 373, 243, 707
20, 1000, 0.3, 0.388, 388, 244, 756
20, 1050, 0.58, 0.397142857143, 417, 248, 802
20, 1100, 0.38, 0.396363636364, 436, 249, 851
20, 1150, 0.44, 0.398260869565, 458, 255, 895
20, 1200, 0.38, 0.3975, 477, 264, 936
20, 1250, 0.36, 0.396, 495, 266, 984
20, 1300, 0.36, 0.394615384615, 513, 270, 1030
20, 1350, 0.36, 0.393333333333, 531, 279, 1071
20, 1400, 0.48, 0.396428571429, 555, 287, 1113
20, 1450, 0.42, 0.39724137931, 576, 290, 1160
20, 1500, 0.42, 0.398, 597, 295, 1205
20, 1550, 0.32, 0.395483870968, 613, 299, 1251
20, 1600, 0.38, 0.395, 632, 306, 1294
20, 1650, 0.32, 0.392727272727, 648, 312, 1338
20, 1700, 0.22, 0.387647058824, 659, 324, 1376
20, 1750, 0.3, 0.385142857143, 674, 330, 1420
20, 1800, 0.48, 0.387777777778, 698, 331, 1469
20, 1850, 0.36, 0.387027027027, 716, 332, 1518
20, 1900, 0.32, 0.385263157895, 732, 334, 1566
20, 1950, 0.34, 0.384102564103, 749, 339, 1611
20, 2000, 0.32, 0.3825, 765, 341, 1659
21, 50, 0.36, 0.36, 18, 23, 27
21, 100, 0.36, 0.36, 36, 52, 48
21, 150, 0.38, 0.366666666667, 55, 80, 70
21, 200, 0.3, 0.35, 70, 104, 96
21, 250, 0.4, 0.36, 90, 130, 120
21, 300, 0.36, 0.36, 108, 154, 146
21, 350, 0.3, 0.351428571429, 123, 181, 169
21, 400, 0.36, 0.3525, 141, 207, 193
21, 450, 0.32, 0.348888888889, 157, 214, 236
21, 500, 0.5, 0.364, 182, 219, 281
21, 550, 0.56, 0.381818181818, 210, 223, 327
21, 600, 0.44, 0.386666666667, 232, 223, 377
21, 650, 0.42, 0.389230769231, 253, 225, 425
21, 700, 0.5, 0.397142857143, 278, 225, 475
21, 750, 0.32, 0.392, 294, 225, 525
21, 800, 0.42, 0.39375, 315, 225, 575
21, 850, 0.38, 0.392941176471, 334, 226, 624
21, 900, 0.38, 0.392222222222, 353, 228, 672
21, 950, 0.4, 0.392631578947, 373, 228, 722
21, 1000, 0.42, 0.394, 394, 228, 772
21, 1050, 0.26, 0.387619047619, 407, 229, 821
21, 1100, 0.34, 0.385454545455, 424, 230, 870
21, 1150, 0.34, 0.38347826087, 441, 230, 920
21, 1200, 0.32, 0.380833333333, 457, 232, 968
21, 1250, 0.44, 0.3832, 479, 232, 1018
21, 1300, 0.16, 0.374615384615, 487, 232, 1068
21, 1350, 0.42, 0.376296296296, 508, 233, 1117
21, 1400, 0.44, 0.378571428571, 530, 234, 1166
21, 1450, 0.46, 0.381379310345, 553, 235, 1215
21, 1500, 0.32, 0.379333333333, 569, 235, 1265
21, 1550, 0.4, 0.38, 589, 235, 1315
21, 1600, 0.54, 0.385, 616, 235, 1365
21, 1650, 0.44, 0.386666666667, 638, 235, 1415
21, 1700, 0.46, 0.388823529412, 661, 236, 1464
21, 1750, 0.34, 0.387428571429, 678, 237, 1513
21, 1800, 0.42, 0.388333333333, 699, 237, 1563
21, 1850, 0.44, 0.38972972973, 721, 237, 1613
21, 1900, 0.28, 0.386842105263, 735, 237, 1663
21, 1950, 0.44, 0.388205128205, 757, 237, 1713
21, 2000, 0.44, 0.3895, 779, 237, 1763
22, 50, 0.32, 0.32, 16, 21, 29
22, 100, 0.36, 0.34, 34, 41, 59
22, 150, 0.34, 0.34, 51, 70, 80
22, 200, 0.36, 0.345, 69, 93, 107
22, 250, 0.38, 0.352, 88, 126, 124
22, 300, 0.34, 0.35, 105, 146, 154
22, 350, 0.38, 0.354285714286, 124, 173, 177
22, 400, 0.34, 0.3525, 141, 203, 197
22, 450, 0.42, 0.36, 162, 229, 221
22, 500, 0.5, 0.374, 187, 257, 243
22, 550, 0.4, 0.376363636364, 207, 283, 267
22, 600, 0.46, 0.383333333333, 230, 312, 288
22, 650, 0.4, 0.384615384615, 250, 333, 317
22, 700, 0.4, 0.385714285714, 270, 364, 336
22, 750, 0.38, 0.385333333333, 289, 390, 360
22, 800, 0.48, 0.39125, 313, 424, 376
22, 850, 0.44, 0.394117647059, 335, 454, 396
22, 900, 0.36, 0.392222222222, 353, 485, 415
22, 950, 0.44, 0.394736842105, 375, 517, 433
22, 1000, 0.54, 0.402, 402, 543, 457
22, 1050, 0.3, 0.397142857143, 417, 565, 485
22, 1100, 0.32, 0.393636363636, 433, 592, 508
22, 1150, 0.32, 0.390434782609, 449, 618, 532
22, 1200, 0.48, 0.394166666667, 473, 650, 550
22, 1250, 0.36, 0.3928, 491, 677, 573
22, 1300, 0.42, 0.393846153846, 512, 704, 596
22, 1350, 0.42, 0.394814814815, 533, 724, 626
22, 1400, 0.34, 0.392857142857, 550, 746, 654
22, 1450, 0.4, 0.393103448276, 570, 762, 688
22, 1500, 0.36, 0.392, 588, 786, 714
22, 1550, 0.5, 0.395483870968, 613, 806, 744
22, 1600, 0.44, 0.396875, 635, 835, 765
22, 1650, 0.32, 0.394545454545, 651, 860, 790
22, 1700, 0.34, 0.392941176471, 668, 877, 823
22, 1750, 0.46, 0.394857142857, 691, 905, 845
22, 1800, 0.32, 0.392777777778, 707, 934, 866
22, 1850, 0.36, 0.391891891892, 725, 962, 888
22, 1900, 0.44, 0.393157894737, 747, 979, 921
22, 1950, 0.44, 0.394358974359, 769, 1001, 949
22, 2000, 0.42, 0.395, 790, 1028, 972
23, 50, 0.36, 0.36, 18, 16, 34
23, 100, 0.5, 0.43, 43, 38, 62
23, 150, 0.42, 0.426666666667, 64, 64, 86
23, 200, 0.52, 0.45, 90, 87, 113
23, 250, 0.44, 0.448, 112, 117, 133
23, 300, 0.42, 0.443333333333, 133, 144, 156
23, 350, 0.38, 0.434285714286, 152, 165, 185
23, 400, 0.58, 0.4525, 181, 190, 210
23, 450, 0.38, 0.444444444444, 200, 218, 232
23, 500, 0.4, 0.44, 220, 230, 270
23, 550, 0.4, 0.436363636364, 240, 251, 299
23, 600, 0.32, 0.426666666667, 256, 278, 322
23, 650, 0.36, 0.421538461538, 274, 299, 351
23, 700, 0.36, 0.417142857143, 292, 319, 381
23, 750, 0.32, 0.410666666667, 308, 333, 417
23, 800, 0.48, 0.415, 332, 352, 448
23, 850, 0.4, 0.414117647059, 352, 380, 470
23, 900, 0.32, 0.408888888889, 368, 408, 492
23, 950, 0.46, 0.411578947368, 391, 428, 522
23, 1000, 0.54, 0.418, 418, 440, 560
23, 1050, 0.42, 0.418095238095, 439, 451, 599
23, 1100, 0.3, 0.412727272727, 454, 462, 638
23, 1150, 0.4, 0.412173913043, 474, 470, 680
23, 1200, 0.38, 0.410833333333, 493, 479, 721
23, 1250, 0.42, 0.4112, 514, 486, 764
23, 1300, 0.38, 0.41, 533, 493, 807
23, 1350, 0.24, 0.403703703704, 545, 497, 853
23, 1400, 0.42, 0.404285714286, 566, 512, 888
23, 1450, 0.6, 0.411034482759, 596, 514, 936
23, 1500, 0.5, 0.414, 621, 516, 984
23, 1550, 0.42, 0.414193548387, 642, 518, 1032
23, 1600, 0.48, 0.41625, 666, 524, 1076
23, 1650, 0.4, 0.415757575758, 686, 525, 1125
23, 1700, 0.5, 0.418235294118, 711, 528, 1172
23, 1750, 0.3, 0.414857142857, 726, 529, 1221
23, 1800, 0.38, 0.413888888889, 745, 531, 1269
23, 1850, 0.5, 0.416216216216, 770, 533, 1317
23, 1900, 0.42, 0.416315789474, 791, 540, 1360
23, 1950, 0.38, 0.415384615385, 810, 542, 1408
23, 2000, 0.4, 0.415, 830, 543, 1457
24, 50, 0.42, 0.42, 21, 28, 22
24, 100, 0.42, 0.42, 42, 54, 46
24, 150, 0.34, 0.393333333333, 59, 77, 73
24, 200, 0.38, 0.39, 78, 96, 104
24, 250, 0.4, 0.392, 98, 122, 128
24, 300, 0.46, 0.403333333333, 121, 140, 160
24, 350, 0.48, 0.414285714286, 145, 167, 183
24, 400, 0.46, 0.42, 168, 195, 205
24, 450, 0.24, 0.4, 180, 208, 242
24, 500, 0.32, 0.392, 196, 222, 278
24, 550, 0.46, 0.398181818182, 219, 244, 306
24, 600, 0.4, 0.398333333333, 239, 250, 350
24, 650, 0.34, 0.393846153846, 256, 256, 394
24, 700, 0.34, 0.39, 273, 266, 434
24, 750, 0.36, 0.388, 291, 279, 471
24, 800, 0.36, 0.38625, 309, 289, 511
24, 850, 0.44, 0.389411764706, 331, 301, 549
24, 900, 0.4, 0.39, 351, 307, 593
24, 950, 0.44, 0.392631578947, 373, 315, 635
24, 1000, 0.34, 0.39, 390, 318, 682
24, 1050, 0.38, 0.389523809524, 409, 329, 721
24, 1100, 0.28, 0.384545454545, 423, 331, 769
24, 1150, 0.4, 0.385217391304, 443, 343, 807
24, 1200, 0.44, 0.3875, 465, 354, 846
24, 1250, 0.42, 0.3888, 486, 369, 881
24, 1300, 0.46, 0.391538461538, 509, 384, 916
24, 1350, 0.48, 0.394814814815, 533, 393, 957
24, 1400, 0.28, 0.390714285714, 547, 400, 1000
24, 1450, 0.42, 0.391724137931, 568, 409, 1041
24, 1500, 0.48, 0.394666666667, 592, 417, 1083
24, 1550, 0.28, 0.390967741935, 606, 425, 1125
24, 1600, 0.4, 0.39125, 626, 429, 1171
24, 1650, 0.38, 0.390909090909, 645, 432, 1218
24, 1700, 0.3, 0.388235294118, 660, 437, 1263
24, 1750, 0.28, 0.385142857143, 674, 442, 1308
24, 1800, 0.5, 0.388333333333, 699, 443, 1357
24, 1850, 0.5, 0.391351351351, 724, 445, 1405
24, 1900, 0.46, 0.393157894737, 747, 449, 1451
24, 1950, 0.3, 0.390769230769, 762, 452, 1498
24, 2000, 0.5, 0.3935, 787, 456, 1544
25, 50, 0.46, 0.46, 23, 27, 23
25, 100, 0.36, 0.41, 41, 53, 47
25, 150, 0.4, 0.406666666667, 61, 79, 71
25, 200, 0.34, 0.39, 78, 104, 96
25, 250, 0.4, 0.392, 98, 131, 119
25, 300, 0.36, 0.386666666667, 116, 157, 143
25, 350, 0.32, 0.377142857143, 132, 186, 164
25, 400, 0.3, 0.3675, 147, 210, 190
25, 450, 0.4, 0.371111111111, 167, 218, 232
25, 500, 0.3, 0.364, 182, 222, 278
25, 550, 0.3, 0.358181818182, 197, 233, 317
25, 600, 0.32, 0.355, 213, 239, 361
25, 650, 0.22, 0.344615384615, 224, 247, 403
25, 700, 0.5, 0.355714285714, 249, 255, 445
25, 750, 0.42, 0.36, 270, 257, 493
25, 800, 0.38, 0.36125, 289, 260, 540
25, 850, 0.4, 0.363529411765, 309, 267, 583
25, 900, 0.38, 0.364444444444, 328, 269, 631
25, 950, 0.5, 0.371578947368, 353, 270, 680
25, 1000, 0.42, 0.374, 374, 272, 728
25, 1050, 0.42, 0.37619047619, 395, 274, 776
25, 1100, 0.42, 0.378181818182, 416, 274, 826
25, 1150, 0.4, 0.379130434783, 436, 276, 874
25, 1200, 0.4, 0.38, 456, 278, 922
25, 1250, 0.36, 0.3792, 474, 278, 972
25, 1300, 0.36, 0.378461538462, 492, 279, 1021
25, 1350, 0.38, 0.378518518519, 511, 280, 1070
25, 1400, 0.52, 0.383571428571, 537, 281, 1119
25, 1450, 0.36, 0.38275862069, 555, 286, 1164
25, 1500, 0.34, 0.381333333333, 572, 287, 1213
25, 1550, 0.34, 0.38, 589, 288, 1262
25, 1600, 0.42, 0.38125, 610, 288, 1312
25, 1650, 0.4, 0.381818181818, 630, 290, 1360
25, 1700, 0.48, 0.384705882353, 654, 290, 1410
25, 1750, 0.44, 0.386285714286, 676, 290, 1460
25, 1800, 0.28, 0.383333333333, 690, 290, 1510
25, 1850, 0.34, 0.382162162162, 707, 292, 1558
25, 1900, 0.42, 0.383157894737, 728, 293, 1607
25, 1950, 0.44, 0.384615384615, 750, 293, 1657
25, 2000, 0.34, 0.3835, 767, 296, 1704
26, 50, 0.46, 0.46, 23, 22, 28
26, 100, 0.32, 0.39, 39, 52, 48
26, 150, 0.3, 0.36, 54, 77, 73
26, 200, 0.34, 0.355, 71, 99, 101
26, 250, 0.44, 0.372, 93, 125, 125
26, 300, 0.4, 0.376666666667, 113, 153, 147
26, 350, 0.38, 0.377142857143, 132, 186, 164
26, 400, 0.38, 0.3775, 151, 207, 193
26, 450, 0.28, 0.366666666667, 165, 215, 235
26, 500, 0.42, 0.372, 186, 225, 275
26, 550, 0.32, 0.367272727273, 202, 230, 320
26, 600, 0.46, 0.375, 225, 236, 364
26, 650, 0.42, 0.378461538462, 246, 243, 407
26, 700, 0.42, 0.381428571429, 267, 246, 454
26, 750, 0.4, 0.382666666667, 287, 248, 502
26, 800, 0.46, 0.3875, 310, 250, 550
26, 850, 0.48, 0.392941176471, 334, 250, 600
26, 900, 0.34, 0.39, 351, 251, 649
26, 950, 0.46, 0.393684210526, 374, 252, 698
26, 1000, 0.38, 0.393, 393, 253, 747
26, 1050, 0.42, 0.394285714286, 414, 256, 794
26, 1100, 0.26, 0.388181818182, 427, 260, 840
26, 1150, 0.44, 0.390434782609, 449, 264, 886
26, 1200, 0.32, 0.3875, 465, 267, 933
26, 1250, 0.38, 0.3872, 484, 270, 980
26, 1300, 0.34, 0.385384615385, 501, 278, 1022
26, 1350, 0.44, 0.387407407407, 523, 283, 1067
26, 1400, 0.32, 0.385, 539, 284, 1116
26, 1450, 0.44, 0.386896551724, 561, 291, 1159
26, 1500, 0.32, 0.384666666667, 577, 293, 1207
26, 1550, 0.3, 0.381935483871, 592, 298, 1252
26, 1600, 0.26, 0.378125, 605, 299, 1301
26, 1650, 0.38, 0.378181818182, 624, 304, 1346
26, 1700, 0.46, 0.380588235294, 647, 308, 1392
26, 1750, 0.42, 0.381714285714, 668, 310, 1440
26, 1800, 0.42, 0.382777777778, 689, 311, 1489
26, 1850, 0.3, 0.380540540541, 704, 314, 1536
26, 1900, 0.44, 0.382105263158, 726, 316, 1584
26, 1950, 0.42, 0.383076923077, 747, 317, 1633
26, 2000, 0.38, 0.383, 766, 317, 1683
27, 50, 0.34, 0.34, 17, 26, 24
27, 100, 0.42, 0.38, 38, 51, 49
27, 150, 0.38, 0.38, 57, 78, 72
27, 200, 0.52, 0.415, 83, 99, 101
27, 250, 0.42, 0.416, 104, 130, 120
27, 300, 0.28, 0.393333333333, 118, 153, 147
27, 350, 0.4, 0.394285714286, 138, 171, 179
27, 400, 0.38, 0.3925, 157, 194, 206
27, 450, 0.38, 0.391111111111, 176, 206, 244
27, 500, 0.42, 0.394, 197, 211, 289
27, 550, 0.4, 0.394545454545, 217, 216, 334
27, 600, 0.38, 0.393333333333, 236, 220, 380
27, 650, 0.4, 0.393846153846, 256, 223, 427
27, 700, 0.32, 0.388571428571, 272, 224, 476
27, 750, 0.36, 0.386666666667, 290, 229, 521
27, 800, 0.38, 0.38625, 309, 230, 570
27, 850, 0.44, 0.389411764706, 331, 230, 620
27, 900, 0.42, 0.391111111111, 352, 232, 668
27, 950, 0.36, 0.389473684211, 370, 233, 717
27, 1000, 0.38, 0.389, 389, 233, 767
27, 1050, 0.32, 0.385714285714, 405, 234, 816
27, 1100, 0.4, 0.386363636364, 425, 236, 864
27, 1150, 0.48, 0.390434782609, 449, 236, 914
27, 1200, 0.32, 0.3875, 465, 237, 963
27, 1250, 0.44, 0.3896, 487, 237, 1013
27, 1300, 0.54, 0.395384615385, 514, 237, 1063
27, 1350, 0.38, 0.394814814815, 533, 237, 1113
27, 1400, 0.42, 0.395714285714, 554, 237, 1163
27, 1450, 0.44, 0.39724137931, 576, 238, 1212
27, 1500, 0.38, 0.396666666667, 595, 239, 1261
27, 1550, 0.54, 0.401290322581, 622, 239, 1311
27, 1600, 0.42, 0.401875, 643, 239, 1361
27, 1650, 0.46, 0.403636363636, 666, 239, 1411
27, 1700, 0.28, 0.4, 680, 239, 1461
27, 1750, 0.54, 0.404, 707, 240, 1510
27, 1800, 0.36, 0.402777777778, 725, 241, 1559
27, 1850, 0.44, 0.403783783784, 747, 242, 1608
27, 1900, 0.46, 0.405263157895, 770, 242, 1658
27, 1950, 0.36, 0.404102564103, 788, 242, 1708
27, 2000, 0.46, 0.4055, 811, 242, 1758
28, 50, 0.44, 0.44, 22, 22, 28
28, 100, 0.46, 0.45, 45, 48, 52
28, 150, 0.38, 0.426666666667, 64, 64, 86
28, 200, 0.44, 0.43, 86, 88, 112
28, 250, 0.46, 0.436, 109, 107, 143
28, 300, 0.26, 0.406666666667, 122, 134, 166
28, 350, 0.38, 0.402857142857, 141, 163, 187
28, 400, 0.44, 0.4075, 163, 192, 208
28, 450, 0.4, 0.406666666667, 183, 208, 242
28, 500, 0.34, 0.4, 200, 224, 276
28, 550, 0.48, 0.407272727273, 224, 231, 319
28, 600, 0.38, 0.405, 243, 236, 364
28, 650, 0.4, 0.404615384615, 263, 239, 411
28, 700, 0.48, 0.41, 287, 244, 456
28, 750, 0.42, 0.410666666667, 308, 248, 502
28, 800, 0.46, 0.41375, 331, 250, 550
28, 850, 0.36, 0.410588235294, 349, 254, 596
28, 900, 0.32, 0.405555555556, 365, 256, 644
28, 950, 0.48, 0.409473684211, 389, 257, 693
28, 1000, 0.36, 0.407, 407, 258, 742
28, 1050, 0.44, 0.408571428571, 429, 261, 789
28, 1100, 0.3, 0.403636363636, 444, 261, 839
28, 1150, 0.4, 0.40347826087, 464, 265, 885
28, 1200, 0.34, 0.400833333333, 481, 266, 934
28, 1250, 0.36, 0.3992, 499, 267, 983
28, 1300, 0.3, 0.395384615385, 514, 276, 1024
28, 1350, 0.44, 0.397037037037, 536, 283, 1067
28, 1400, 0.36, 0.395714285714, 554, 284, 1116
28, 1450, 0.4, 0.395862068966, 574, 286, 1164
28, 1500, 0.38, 0.395333333333, 593, 286, 1214
28, 1550, 0.4, 0.395483870968, 613, 289, 1261
28, 1600, 0.3, 0.3925, 628, 290, 1310
28, 1650, 0.48, 0.395151515152, 652, 290, 1360
28, 1700, 0.4, 0.395294117647, 672, 290, 1410
28, 1750, 0.32, 0.393142857143, 688, 291, 1459
28, 1800, 0.4, 0.393333333333, 708, 294, 1506
28, 1850, 0.44, 0.394594594595, 730, 297, 1553
28, 1900, 0.4, 0.394736842105, 750, 299, 1601
28, 1950, 0.32, 0.392820512821, 766, 301, 1649
28, 2000, 0.5, 0.3955, 791, 301, 1699
29, 50, 0.32, 0.32, 16, 26, 24
29, 100, 0.38, 0.35, 35, 49, 51
29, 150, 0.34, 0.346666666667, 52, 79, 71
29, 200, 0.44, 0.37, 74, 104, 96
29, 250, 0.38, 0.372, 93, 132, 118
29, 300, 0.36, 0.37, 111, 153, 147
29, 350, 0.4, 0.374285714286, 131, 181, 169
29, 400, 0.44, 0.3825, 153, 198, 202
29, 450, 0.42, 0.386666666667, 174, 218, 232
29, 500, 0.38, 0.386, 193, 238, 262
29, 550, 0.34, 0.381818181818, 210, 254, 296
29, 600, 0.38, 0.381666666667, 229, 271, 329
29, 650, 0.4, 0.383076923077, 249, 283, 367
29, 700, 0.32, 0.378571428571, 265, 300, 400
29, 750, 0.4, 0.38, 285, 311, 439
29, 800, 0.4, 0.38125, 305, 318, 482
29, 850, 0.28, 0.375294117647, 319, 327, 523
29, 900, 0.46, 0.38, 342, 334, 566
29, 950, 0.4, 0.381052631579, 362, 340, 610
29, 1000, 0.4, 0.382, 382, 347, 653
29, 1050, 0.36, 0.380952380952, 400, 353, 697
29, 1100, 0.44, 0.383636363636, 422, 355, 745
29, 1150, 0.46, 0.386956521739, 445, 361, 789
29, 1200, 0.4, 0.3875, 465, 365, 835
29, 1250, 0.42, 0.3888, 486, 368, 882
29, 1300, 0.4, 0.389230769231, 506, 379, 921
29, 1350, 0.32, 0.386666666667, 522, 388, 962
29, 1400, 0.44, 0.388571428571, 544, 395, 1005
29, 1450, 0.34, 0.386896551724, 561, 401, 1049
29, 1500, 0.4, 0.387333333333, 581, 408, 1092
29, 1550, 0.36, 0.386451612903, 599, 410, 1140
29, 1600, 0.44, 0.388125, 621, 414, 1186
29, 1650, 0.36, 0.387272727273, 639, 419, 1231
29, 1700, 0.4, 0.387647058824, 659, 423, 1277
29, 1750, 0.38, 0.387428571429, 678, 426, 1324
29, 1800, 0.36, 0.386666666667, 696, 429, 1371
29, 1850, 0.44, 0.388108108108, 718, 430, 1420
29, 1900, 0.48, 0.390526315789, 742, 433, 1467
29, 1950, 0.38, 0.390256410256, 761, 434, 1516
29, 2000, 0.42, 0.391, 782, 439, 1561
30, 50, 0.48, 0.48, 24, 23, 27
30, 100, 0.46, 0.47, 47, 51, 49
30, 150, 0.4, 0.446666666667, 67, 77, 73
30, 200, 0.36, 0.425, 85, 101, 99
30, 250, 0.44, 0.428, 107, 127, 123
30, 300, 0.32, 0.41, 123, 151, 149
30, 350, 0.4, 0.408571428571, 143, 177, 173
30, 400, 0.32, 0.3975, 159, 207, 193
30, 450, 0.4, 0.397777777778, 179, 230, 220
30, 500, 0.36, 0.394, 197, 260, 240
30, 550, 0.38, 0.392727272727, 216, 286, 264
30, 600, 0.42, 0.395, 237, 311, 289
30, 650, 0.44, 0.398461538462, 259, 337, 313
30, 700, 0.4, 0.398571428571, 279, 360, 340
30, 750, 0.52, 0.406666666667, 305, 397, 353
30, 800, 0.46, 0.41, 328, 430, 370
30, 850, 0.36, 0.407058823529, 346, 460, 390
30, 900, 0.38, 0.405555555556, 365, 493, 407
30, 950, 0.36, 0.403157894737, 383, 528, 422
30, 1000, 0.34, 0.4, 400, 567, 433
30, 1050, 0.44, 0.401904761905, 422, 606, 444
30, 1100, 0.32, 0.398181818182, 438, 650, 450
30, 1150, 0.32, 0.394782608696, 454, 687, 463
30, 1200, 0.38, 0.394166666667, 473, 719, 481
30, 1250, 0.5, 0.3984, 498, 747, 503
30, 1300, 0.3, 0.394615384615, 513, 773, 527
30, 1350, 0.38, 0.394074074074, 532, 810, 540
30, 1400, 0.4, 0.394285714286, 552, 843, 557
30, 1450, 0.4, 0.394482758621, 572, 881, 569
30, 1500, 0.38, 0.394, 591, 916, 584
30, 1550, 0.4, 0.394193548387, 611, 946, 604
30, 1600, 0.36, 0.393125, 629, 978, 622
30, 1650, 0.46, 0.395151515152, 652, 1002, 648
30, 1700, 0.42, 0.395882352941, 673, 1024, 676
30, 1750, 0.44, 0.397142857143, 695, 1041, 709
30, 1800, 0.28, 0.393888888889, 709, 1067, 733
30, 1850, 0.34, 0.392432432432, 726, 1095, 755
30, 1900, 0.38, 0.392105263158, 745, 1115, 785
30, 1950, 0.36, 0.391282051282, 763, 1132, 818
30, 2000, 0.4, 0.3915, 783, 1149, 851
31, 50, 0.32, 0.32, 16, 28, 22
31, 100, 0.44, 0.38, 38, 53, 47
31, 150, 0.36, 0.373333333333, 56, 77, 73
31, 200, 0.44, 0.39, 78, 104, 96
31, 250, 0.54, 0.42, 105, 123, 127
31, 300, 0.36, 0.41, 123, 150, 150
31, 350, 0.4, 0.408571428571, 143, 172, 178
31, 400, 0.34, 0.4, 160, 200, 200
31, 450, 0.4, 0.4, 180, 220, 230
31, 500, 0.32, 0.392, 196, 234, 266
31, 550, 0.46, 0.398181818182, 219, 255, 295
31, 600, 0.3, 0.39, 234, 273, 327
31, 650, 0.46, 0.395384615385, 257, 289, 361
31, 700, 0.34, 0.391428571429, 274, 312, 388
31, 750, 0.42, 0.393333333333, 295, 346, 404
31, 800, 0.4, 0.39375, 315, 374, 426
31, 850, 0.34, 0.390588235294, 332, 412, 438
31, 900, 0.38, 0.39, 351, 446, 454
31, 950, 0.32, 0.386315789474, 367, 480, 470
31, 1000, 0.32, 0.383, 383, 514, 486
31, 1050, 0.4, 0.38380952381, 403, 547, 503
31, 1100, 0.26, 0.378181818182, 416, 575, 525
31, 1150, 0.34, 0.37652173913, 433, 604, 546
31, 1200, 0.44, 0.379166666667, 455, 633, 567
31, 1250, 0.52, 0.3848, 481, 654, 596
31, 1300, 0.42, 0.386153846154, 502, 676, 624
31, 1350, 0.34, 0.384444444444, 519, 708, 642
31, 1400, 0.28, 0.380714285714, 533, 732, 668
31, 1450, 0.3, 0.377931034483, 548, 762, 688
31, 1500, 0.28, 0.374666666667, 562, 787, 713
31, 1550, 0.32, 0.372903225806, 578, 808, 742
31, 1600, 0.42, 0.374375, 599, 836, 764
31, 1650, 0.48, 0.377575757576, 623, 867, 783
31, 1700, 0.46, 0.38, 646, 898, 802
31, 1750, 0.32, 0.378285714286, 662, 932, 818
31, 1800, 0.4, 0.378888888889, 682, 966, 834
31, 1850, 0.32, 0.377297297297, 698, 999, 851
31, 1900, 0.26, 0.374210526316, 711, 1033, 867
31, 1950, 0.34, 0.373333333333, 728, 1070, 880
31, 2000, 0.3, 0.3715, 743, 1107, 893
32, 50, 0.44, 0.44, 22, 24, 26
32, 100, 0.46, 0.45, 45, 50, 50
32, 150, 0.4, 0.433333333333, 65, 73, 77
32, 200, 0.24, 0.385, 77, 102, 98
32, 250, 0.54, 0.416, 104, 128, 122
32, 300, 0.3, 0.396666666667, 119, 146, 154
32, 350, 0.32, 0.385714285714, 135, 178, 172
32, 400, 0.44, 0.3925, 157, 205, 195
32, 450, 0.36, 0.388888888889, 175, 225, 225
32, 500, 0.46, 0.396, 198, 247, 253
32, 550, 0.4, 0.396363636364, 218, 261, 289
32, 600, 0.28, 0.386666666667, 232, 282, 318
32, 650, 0.38, 0.386153846154, 251, 299, 351
32, 700, 0.26, 0.377142857143, 264, 312, 388
32, 750, 0.32, 0.373333333333, 280, 323, 427
32, 800, 0.34, 0.37125, 297, 334, 466
32, 850, 0.48, 0.377647058824, 321, 342, 508
32, 900, 0.28, 0.372222222222, 335, 352, 548
32, 950, 0.3, 0.368421052632, 350, 364, 586
32, 1000, 0.38, 0.369, 369, 372, 628
32, 1050, 0.4, 0.370476190476, 389, 378, 672
32, 1100, 0.38, 0.370909090909, 408, 382, 718
32, 1150, 0.5, 0.37652173913, 433, 384, 766
32, 1200, 0.32, 0.374166666667, 449, 389, 811
32, 1250, 0.4, 0.3752, 469, 392, 858
32, 1300, 0.4, 0.376153846154, 489, 394, 906
32, 1350, 0.48, 0.38, 513, 396, 954
32, 1400, 0.3, 0.377142857143, 528, 398, 1002
32, 1450, 0.4, 0.377931034483, 548, 401, 1049
32, 1500, 0.4, 0.378666666667, 568, 404, 1096
32, 1550, 0.34, 0.377419354839, 585, 405, 1145
32, 1600, 0.4, 0.378125, 605, 407, 1193
32, 1650, 0.32, 0.376363636364, 621, 410, 1240
32, 1700, 0.42, 0.377647058824, 642, 411, 1289
32, 1750, 0.4, 0.378285714286, 662, 412, 1338
32, 1800, 0.5, 0.381666666667, 687, 413, 1387
32, 1850, 0.32, 0.38, 703, 413, 1437
32, 1900, 0.24, 0.376315789474, 715, 414, 1486
32, 1950, 0.4, 0.376923076923, 735, 416, 1534
32, 2000, 0.44, 0.3785, 757, 416, 1584
33, 50, 0.32, 0.32, 16, 19, 31
33, 100, 0.4, 0.36, 36, 44, 56
33, 150, 0.46, 0.393333333333, 59, 67, 83
33, 200, 0.26, 0.36, 72, 95, 105
33, 250, 0.34, 0.356, 89, 116, 134
33, 300, 0.36, 0.356666666667, 107, 140, 160
33, 350, 0.3, 0.348571428571, 122, 165, 185
33, 400, 0.3, 0.3425, 137, 198, 202
33, 450, 0.24, 0.331111111111, 149, 233, 217
33, 500, 0.36, 0.334, 167, 265, 235
33, 550, 0.42, 0.341818181818, 188, 296, 254
33, 600, 0.4, 0.346666666667, 208, 337, 263
33, 650, 0.26, 0.34, 221, 375, 275
33, 700, 0.18, 0.328571428571, 230, 409, 291
33, 750, 0.42, 0.334666666667, 251, 436, 314
33, 800, 0.36, 0.33625, 269, 466, 334
33, 850, 0.42, 0.341176470588, 290, 495, 355
33, 900, 0.46, 0.347777777778, 313, 519, 381
33, 950, 0.34, 0.347368421053, 330, 550, 400
33, 1000, 0.5, 0.355, 355, 582, 418
33, 1050, 0.38, 0.35619047619, 374, 619, 431
33, 1100, 0.44, 0.36, 396, 653, 447
33, 1150, 0.38, 0.360869565217, 415, 694, 456
33, 1200, 0.32, 0.359166666667, 431, 734, 466
33, 1250, 0.4, 0.3608, 451, 769, 481
33, 1300, 0.4, 0.362307692308, 471, 807, 493
33, 1350, 0.44, 0.365185185185, 493, 849, 501
33, 1400, 0.38, 0.365714285714, 512, 896, 504
33, 1450, 0.34, 0.364827586207, 529, 941, 509
33, 1500, 0.26, 0.361333333333, 542, 978, 522
33, 1550, 0.56, 0.367741935484, 570, 1023, 527
33, 1600, 0.36, 0.3675, 588, 1065, 535
33, 1650, 0.38, 0.367878787879, 607, 1111, 539
33, 1700, 0.38, 0.368235294118, 626, 1153, 547
33, 1750, 0.34, 0.367428571429, 643, 1193, 557
33, 1800, 0.44, 0.369444444444, 665, 1237, 563
33, 1850, 0.32, 0.368108108108, 681, 1274, 576
33, 1900, 0.32, 0.366842105263, 697, 1313, 587
33, 1950, 0.34, 0.366153846154, 714, 1347, 603
33, 2000, 0.28, 0.364, 728, 1388, 612
34, 50, 0.3, 0.3, 15, 26, 24
34, 100, 0.42, 0.36, 36, 53, 47
34, 150, 0.42, 0.38, 57, 82, 68
34, 200, 0.46, 0.4, 80, 109, 91
34, 250, 0.32, 0.384, 96, 129, 121
34, 300, 0.42, 0.39, 117, 155, 145
34, 350, 0.24, 0.368571428571, 129, 181, 169
34, 400, 0.36, 0.3675, 147, 201, 199
34, 450, 0.44, 0.375555555556, 169, 214, 236
34, 500, 0.36, 0.374, 187, 220, 280
34, 550, 0.48, 0.383636363636, 211, 228, 322
34, 600, 0.38, 0.383333333333, 230, 232, 368
34, 650, 0.48, 0.390769230769, 254, 233, 417
34, 700, 0.44, 0.394285714286, 276, 237, 463
34, 750, 0.42, 0.396, 297, 237, 513
34, 800, 0.34, 0.3925, 314, 240, 560
34, 850, 0.32, 0.388235294118, 330, 243, 607
34, 900, 0.5, 0.394444444444, 355, 243, 657
34, 950, 0.34, 0.391578947368, 372, 245, 705
34, 1000, 0.24, 0.384, 384, 250, 750
34, 1050, 0.4, 0.384761904762, 404, 255, 795
34, 1100, 0.46, 0.388181818182, 427, 259, 841
34, 1150, 0.38, 0.387826086957, 446, 268, 882
34, 1200, 0.3, 0.384166666667, 461, 275, 925
34, 1250, 0.36, 0.3832, 479, 283, 967
34, 1300, 0.46, 0.386153846154, 502, 285, 1015
34, 1350, 0.34, 0.384444444444, 519, 287, 1063
34, 1400, 0.26, 0.38, 532, 288, 1112
34, 1450, 0.36, 0.379310344828, 550, 293, 1157
34, 1500, 0.4, 0.38, 570, 296, 1204
34, 1550, 0.48, 0.383225806452, 594, 303, 1247
34, 1600, 0.44, 0.385, 616, 309, 1291
34, 1650, 0.36, 0.384242424242, 634, 313, 1337
34, 1700, 0.28, 0.381176470588, 648, 320, 1380
34, 1750, 0.28, 0.378285714286, 662, 326, 1424
34, 1800, 0.44, 0.38, 684, 338, 1462
34, 1850, 0.42, 0.381081081081, 705, 343, 1507
34, 1900, 0.34, 0.38, 722, 362, 1538
34, 1950, 0.38, 0.38, 741, 375, 1575
34, 2000, 0.5, 0.383, 766, 382, 1618
35, 50, 0.4, 0.4, 20, 24, 26
35, 100, 0.36, 0.38, 38, 49, 51
35, 150, 0.4, 0.386666666667, 58, 77, 73
35, 200, 0.38, 0.385, 77, 96, 104
35, 250, 0.4, 0.388, 97, 119, 131
35, 300, 0.42, 0.393333333333, 118, 144, 156
35, 350, 0.36, 0.388571428571, 136, 171, 179
35, 400, 0.34, 0.3825, 153, 195, 205
35, 450, 0.4, 0.384444444444, 173, 220, 230
35, 500, 0.42, 0.388, 194, 251, 249
35, 550, 0.3, 0.38, 209, 291, 259
35, 600, 0.34, 0.376666666667, 226, 322, 278
35, 650, 0.42, 0.38, 247, 355, 295
35, 700, 0.34, 0.377142857143, 264, 397, 303
35, 750, 0.34, 0.374666666667, 281, 427, 323
35, 800, 0.44, 0.37875, 303, 456, 344
35, 850, 0.46, 0.383529411765, 326, 485, 365
35, 900, 0.3, 0.378888888889, 341, 508, 392
35, 950, 0.3, 0.374736842105, 356, 529, 421
35, 1000, 0.44, 0.378, 378, 561, 439
35, 1050, 0.5, 0.38380952381, 403, 591, 459
35, 1100, 0.4, 0.384545454545, 423, 622, 478
35, 1150, 0.52, 0.390434782609, 449, 643, 507
35, 1200, 0.38, 0.39, 468, 658, 542
35, 1250, 0.42, 0.3912, 489, 669, 581
35, 1300, 0.48, 0.394615384615, 513, 683, 617
35, 1350, 0.46, 0.397037037037, 536, 698, 652
35, 1400, 0.34, 0.395, 553, 711, 689
35, 1450, 0.38, 0.394482758621, 572, 721, 729
35, 1500, 0.38, 0.394, 591, 729, 771
35, 1550, 0.42, 0.394838709677, 612, 733, 817
35, 1600, 0.24, 0.39, 624, 740, 860
35, 1650, 0.34, 0.388484848485, 641, 749, 901
35, 1700, 0.46, 0.390588235294, 664, 758, 942
35, 1750, 0.3, 0.388, 679, 769, 981
35, 1800, 0.32, 0.386111111111, 695, 783, 1017
35, 1850, 0.36, 0.385405405405, 713, 801, 1049
35, 1900, 0.34, 0.384210526316, 730, 810, 1090
35, 1950, 0.26, 0.381025641026, 743, 820, 1130
35, 2000, 0.44, 0.3825, 765, 827, 1173
36, 50, 0.34, 0.34, 17, 31, 19
36, 100, 0.3, 0.32, 32, 57, 43
36, 150, 0.32, 0.32, 48, 83, 67
36, 200, 0.38, 0.335, 67, 109, 91
36, 250, 0.4, 0.348, 87, 133, 117
36, 300, 0.28, 0.336666666667, 101, 165, 135
36, 350, 0.34, 0.337142857143, 118, 183, 167
36, 400, 0.38, 0.3425, 137, 208, 192
36, 450, 0.38, 0.346666666667, 156, 219, 231
36, 500, 0.48, 0.36, 180, 223, 277
36, 550, 0.48, 0.370909090909, 204, 226, 324
36, 600, 0.3, 0.365, 219, 228, 372
36, 650, 0.44, 0.370769230769, 241, 230, 420
36, 700, 0.38, 0.371428571429, 260, 233, 467
36, 750, 0.38, 0.372, 279, 238, 512
36, 800, 0.48, 0.37875, 303, 239, 561
36, 850, 0.52, 0.387058823529, 329, 239, 611
36, 900, 0.38, 0.386666666667, 348, 240, 660
36, 950, 0.54, 0.394736842105, 375, 240, 710
36, 1000, 0.38, 0.394, 394, 240, 760
36, 1050, 0.4, 0.394285714286, 414, 241, 809
36, 1100, 0.5, 0.399090909091, 439, 242, 858
36, 1150, 0.4, 0.399130434783, 459, 242, 908
36, 1200, 0.46, 0.401666666667, 482, 242, 958
36, 1250, 0.44, 0.4032, 504, 242, 1008
36, 1300, 0.28, 0.398461538462, 518, 242, 1058
36, 1350, 0.4, 0.398518518519, 538, 243, 1107
36, 1400, 0.5, 0.402142857143, 563, 244, 1156
36, 1450, 0.44, 0.403448275862, 585, 244, 1206
36, 1500, 0.42, 0.404, 606, 244, 1256
36, 1550, 0.44, 0.405161290323, 628, 244, 1306
36, 1600, 0.52, 0.40875, 654, 244, 1356
36, 1650, 0.44, 0.409696969697, 676, 244, 1406
36, 1700, 0.4, 0.409411764706, 696, 244, 1456
36, 1750, 0.5, 0.412, 721, 244, 1506
36, 1800, 0.4, 0.411666666667, 741, 244, 1556
36, 1850, 0.38, 0.410810810811, 760, 244, 1606
36, 1900, 0.36, 0.409473684211, 778, 244, 1656
36, 1950, 0.36, 0.408205128205, 796, 244, 1706
36, 2000, 0.4, 0.408, 816, 244, 1756
37, 50, 0.42, 0.42, 21, 24, 26
37, 100, 0.34, 0.38, 38, 52, 48
37, 150, 0.54, 0.433333333333, 65, 78, 72
37, 200, 0.4, 0.425, 85, 105, 95
37, 250, 0.34, 0.408, 102, 127, 123
37, 300, 0.26, 0.383333333333, 115, 147, 153
37, 350, 0.42, 0.388571428571, 136, 175, 175
37, 400, 0.36, 0.385, 154, 205, 195
37, 450, 0.24, 0.368888888889, 166, 235, 215
37, 500, 0.38, 0.37, 185, 258, 242
37, 550, 0.5, 0.381818181818, 210, 267, 283
37, 600, 0.28, 0.373333333333, 224, 288, 312
37, 650, 0.3, 0.367692307692, 239, 306, 344
37, 700, 0.3, 0.362857142857, 254, 325, 375
37, 750, 0.4, 0.365333333333, 274, 350, 400
37, 800, 0.46, 0.37125, 297, 367, 433
37, 850, 0.48, 0.377647058824, 321, 378, 472
37, 900, 0.44, 0.381111111111, 343, 390, 510
37, 950, 0.52, 0.388421052632, 369, 401, 549
37, 1000, 0.38, 0.388, 388, 413, 587
37, 1050, 0.44, 0.390476190476, 410, 428, 622
37, 1100, 0.38, 0.39, 429, 434, 666
37, 1150, 0.44, 0.392173913043, 451, 443, 707
37, 1200, 0.42, 0.393333333333, 472, 447, 753
37, 1250, 0.3, 0.3896, 487, 453, 797
37, 1300, 0.4, 0.39, 507, 463, 837
37, 1350, 0.26, 0.385185185185, 520, 476, 874
37, 1400, 0.42, 0.386428571429, 541, 492, 908
37, 1450, 0.24, 0.381379310345, 553, 515, 935
37, 1500, 0.36, 0.380666666667, 571, 528, 972
37, 1550, 0.38, 0.38064516129, 590, 550, 1000
37, 1600, 0.38, 0.380625, 609, 575, 1025
37, 1650, 0.3, 0.378181818182, 624, 595, 1055
37, 1700, 0.36, 0.377647058824, 642, 613, 1087
37, 1750, 0.46, 0.38, 665, 631, 1119
37, 1800, 0.32, 0.378333333333, 681, 651, 1149
37, 1850, 0.34, 0.377297297297, 698, 664, 1186
37, 1900, 0.44, 0.378947368421, 720, 681, 1219
37, 1950, 0.38, 0.378974358974, 739, 693, 1257
37, 2000, 0.44, 0.3805, 761, 709, 1291
38, 50, 0.28, 0.28, 14, 24, 26
38, 100, 0.34, 0.31, 31, 42, 58
38, 150, 0.38, 0.333333333333, 50, 68, 82
38, 200, 0.3, 0.325, 65, 94, 106
38, 250, 0.3, 0.32, 80, 119, 131
38, 300, 0.36, 0.326666666667, 98, 136, 164
38, 350, 0.42, 0.34, 119, 166, 184
38, 400, 0.34, 0.34, 136, 191, 209
38, 450, 0.46, 0.353333333333, 159, 224, 226
38, 500, 0.38, 0.356, 178, 259, 241
38, 550, 0.3, 0.350909090909, 193, 296, 254
38, 600, 0.4, 0.355, 213, 313, 287
38, 650, 0.42, 0.36, 234, 343, 307
38, 700, 0.28, 0.354285714286, 248, 367, 333
38, 750, 0.32, 0.352, 264, 381, 369
38, 800, 0.3, 0.34875, 279, 395, 405
38, 850, 0.44, 0.354117647059, 301, 403, 447
38, 900, 0.3, 0.351111111111, 316, 413, 487
38, 950, 0.26, 0.346315789474, 329, 431, 519
38, 1000, 0.28, 0.343, 343, 458, 542
38, 1050, 0.36, 0.34380952381, 361, 483, 567
38, 1100, 0.42, 0.347272727273, 382, 508, 592
38, 1150, 0.46, 0.352173913043, 405, 528, 622
38, 1200, 0.32, 0.350833333333, 421, 548, 652
38, 1250, 0.36, 0.3512, 439, 562, 688
38, 1300, 0.3, 0.349230769231, 454, 579, 721
38, 1350, 0.22, 0.344444444444, 465, 591, 759
38, 1400, 0.4, 0.346428571429, 485, 600, 800
38, 1450, 0.38, 0.347586206897, 504, 616, 834
38, 1500, 0.4, 0.349333333333, 524, 642, 858
38, 1550, 0.44, 0.352258064516, 546, 660, 890
38, 1600, 0.4, 0.35375, 566, 684, 916
38, 1650, 0.34, 0.353333333333, 583, 700, 950
38, 1700, 0.42, 0.355294117647, 604, 712, 988
38, 1750, 0.34, 0.354857142857, 621, 724, 1026
38, 1800, 0.4, 0.356111111111, 641, 739, 1061
38, 1850, 0.5, 0.36, 666, 748, 1102
38, 1900, 0.3, 0.358421052632, 681, 764, 1136
38, 1950, 0.36, 0.358461538462, 699, 773, 1177
38, 2000, 0.36, 0.3585, 717, 786, 1214
39, 50, 0.26, 0.26, 13, 28, 22
39, 100, 0.54, 0.4, 40, 55, 45
39, 150, 0.24, 0.346666666667, 52, 81, 69
39, 200, 0.38, 0.355, 71, 102, 98
39, 250, 0.38, 0.36, 90, 131, 119
39, 300, 0.34, 0.356666666667, 107, 157, 143
39, 350, 0.44, 0.368571428571, 129, 185, 165
39, 400, 0.38, 0.37, 148, 209, 191
39, 450, 0.44, 0.377777777778, 170, 227, 223
39, 500, 0.56, 0.396, 198, 234, 266
39, 550, 0.48, 0.403636363636, 222, 235, 315
39, 600, 0.44, 0.406666666667, 244, 235, 365
39, 650, 0.42, 0.407692307692, 265, 237, 413
39, 700, 0.34, 0.402857142857, 282, 239, 461
39, 750, 0.38, 0.401333333333, 301, 240, 510
39, 800, 0.3, 0.395, 316, 241, 559
39, 850, 0.38, 0.394117647059, 335, 242, 608
39, 900, 0.38, 0.393333333333, 354, 245, 655
39, 950, 0.58, 0.403157894737, 383, 248, 702
39, 1000, 0.32, 0.399, 399, 249, 751
39, 1050, 0.28, 0.393333333333, 413, 252, 798
39, 1100, 0.4, 0.393636363636, 433, 256, 844
39, 1150, 0.34, 0.391304347826, 450, 258, 892
39, 1200, 0.5, 0.395833333333, 475, 261, 939
39, 1250, 0.4, 0.396, 495, 265, 985
39, 1300, 0.34, 0.393846153846, 512, 270, 1030
39, 1350, 0.56, 0.4, 540, 274, 1076
39, 1400, 0.46, 0.402142857143, 563, 284, 1116
39, 1450, 0.44, 0.403448275862, 585, 286, 1164
39, 1500, 0.4, 0.403333333333, 605, 293, 1207
39, 1550, 0.54, 0.407741935484, 632, 295, 1255
39, 1600, 0.36, 0.40625, 650, 298, 1302
39, 1650, 0.42, 0.406666666667, 671, 301, 1349
39, 1700, 0.32, 0.404117647059, 687, 305, 1395
39, 1750, 0.36, 0.402857142857, 705, 311, 1439
39, 1800, 0.44, 0.403888888889, 727, 314, 1486
39, 1850, 0.46, 0.405405405405, 750, 321, 1529
39, 1900, 0.34, 0.403684210526, 767, 329, 1571
39, 1950, 0.38, 0.403076923077, 786, 333, 1617
39, 2000, 0.4, 0.403, 806, 334, 1666
40, 50, 0.36, 0.36, 18, 25, 25
40, 100, 0.42, 0.39, 39, 52, 48
40, 150, 0.38, 0.386666666667, 58, 74, 76
40, 200, 0.44, 0.4, 80, 100, 100
40, 250, 0.28, 0.376, 94, 119, 131
40, 300, 0.38, 0.376666666667, 113, 140, 160
40, 350, 0.36, 0.374285714286, 131, 159, 191
40, 400, 0.3, 0.365, 146, 184, 216
40, 450, 0.34, 0.362222222222, 163, 221, 229
40, 500, 0.42, 0.368, 184, 259, 241
40, 550, 0.46, 0.376363636364, 207, 296, 254
40, 600, 0.44, 0.381666666667, 229, 332, 268
40, 650, 0.4, 0.383076923077, 249, 359, 291
40, 700, 0.5, 0.391428571429, 274, 390, 310
40, 750, 0.38, 0.390666666667, 293, 421, 329
40, 800, 0.4, 0.39125, 313, 449, 351
40, 850, 0.3, 0.385882352941, 328, 479, 371
40, 900, 0.38, 0.385555555556, 347, 506, 394
40, 950, 0.6, 0.396842105263, 377, 526, 424
40, 1000, 0.3, 0.392, 392, 549, 451
40, 1050, 0.24, 0.384761904762, 404, 576, 474
40, 1100, 0.44, 0.387272727273, 426, 600, 500
40, 1150, 0.36, 0.386086956522, 444, 615, 535
40, 1200, 0.46, 0.389166666667, 467, 627, 573
40, 1250, 0.36, 0.388, 485, 636, 614
40, 1300, 0.3, 0.384615384615, 500, 658, 642
40, 1350, 0.42, 0.385925925926, 521, 682, 668
40, 1400, 0.28, 0.382142857143, 535, 708, 692
40, 1450, 0.36, 0.381379310345, 553, 735, 715
40, 1500, 0.36, 0.380666666667, 571, 759, 741
40, 1550, 0.44, 0.382580645161, 593, 785, 765
40, 1600, 0.46, 0.385, 616, 813, 787
40, 1650, 0.4, 0.385454545455, 636, 838, 812
40, 1700, 0.34, 0.384117647059, 653, 864, 836
40, 1750, 0.3, 0.381714285714, 668, 887, 863
40, 1800, 0.38, 0.381666666667, 687, 902, 898
40, 1850, 0.44, 0.383243243243, 709, 926, 924
40, 1900, 0.44, 0.384736842105, 731, 944, 956
40, 1950, 0.42, 0.385641025641, 752, 962, 988
40, 2000, 0.58, 0.3905, 781, 984, 1016
41, 50, 0.36, 0.36, 18, 23, 27
41, 100, 0.44, 0.4, 40, 51, 49
41, 150, 0.46, 0.42, 63, 76, 74
41, 200, 0.46, 0.43, 86, 101, 99
41, 250, 0.36, 0.416, 104, 123, 127
41, 300, 0.36, 0.406666666667, 122, 147, 153
41, 350, 0.44, 0.411428571429, 144, 174, 176
41, 400, 0.34, 0.4025, 161, 201, 199
41, 450, 0.4, 0.402222222222, 181, 236, 214
41, 500, 0.34, 0.396, 198, 279, 221
41, 550, 0.32, 0.389090909091, 214, 320, 230
41, 600, 0.34, 0.385, 231, 352, 248
41, 650, 0.38, 0.384615384615, 250, 389, 261
41, 700, 0.44, 0.388571428571, 272, 429, 271
41, 750, 0.38, 0.388, 291, 465, 285
41, 800, 0.38, 0.3875, 310, 508, 292
41, 850, 0.4, 0.388235294118, 330, 549, 301
41, 900, 0.36, 0.386666666667, 348, 591, 309
41, 950, 0.42, 0.388421052632, 369, 630, 320
41, 1000, 0.34, 0.386, 386, 670, 330
41, 1050, 0.3, 0.381904761905, 401, 708, 342
41, 1100, 0.4, 0.382727272727, 421, 747, 353
41, 1150, 0.3, 0.379130434783, 436, 790, 360
41, 1200, 0.28, 0.375, 450, 825, 375
41, 1250, 0.32, 0.3728, 466, 863, 387
41, 1300, 0.42, 0.374615384615, 487, 903, 397
41, 1350, 0.38, 0.374814814815, 506, 944, 406
41, 1400, 0.3, 0.372142857143, 521, 984, 416
41, 1450, 0.2, 0.366206896552, 531, 1027, 423
41, 1500, 0.26, 0.362666666667, 544, 1064, 436
41, 1550, 0.32, 0.361290322581, 560, 1105, 445
41, 1600, 0.42, 0.363125, 581, 1140, 460
41, 1650, 0.36, 0.36303030303, 599, 1177, 473
41, 1700, 0.4, 0.364117647059, 619, 1217, 483
41, 1750, 0.38, 0.364571428571, 638, 1252, 498
41, 1800, 0.38, 0.365, 657, 1296, 504
41, 1850, 0.46, 0.367567567568, 680, 1342, 508
41, 1900, 0.38, 0.367894736842, 699, 1381, 519
41, 1950, 0.36, 0.367692307692, 717, 1426, 524
41, 2000, 0.5, 0.371, 742, 1471, 529
42, 50, 0.28, 0.28, 14, 28, 22
42, 100, 0.38, 0.33, 33, 48, 52
42, 150, 0.38, 0.346666666667, 52, 75, 75
42, 200, 0.44, 0.37, 74, 98, 102
42, 250, 0.3, 0.356, 89, 124, 126
42, 300, 0.42, 0.366666666667, 110, 152, 148
42, 350, 0.34, 0.362857142857, 127, 176, 174
42, 400, 0.32, 0.3575, 143, 207, 193
42, 450, 0.44, 0.366666666667, 165, 241, 209
42, 500, 0.34, 0.364, 182, 280, 220
42, 550, 0.58, 0.383636363636, 211, 323, 227
42, 600, 0.36, 0.381666666667, 229, 368, 232
42, 650, 0.26, 0.372307692308, 242, 413, 237
42, 700, 0.38, 0.372857142857, 261, 456, 244
42, 750, 0.34, 0.370666666667, 278, 500, 250
42, 800, 0.42, 0.37375, 299, 544, 256
42, 850, 0.34, 0.371764705882, 316, 583, 267
42, 900, 0.42, 0.374444444444, 337, 621, 279
42, 950, 0.56, 0.384210526316, 365, 659, 291
42, 1000, 0.36, 0.383, 383, 699, 301
42, 1050, 0.4, 0.38380952381, 403, 747, 303
42, 1100, 0.28, 0.379090909091, 417, 793, 307
42, 1150, 0.4, 0.38, 437, 838, 312
42, 1200, 0.4, 0.380833333333, 457, 883, 317
42, 1250, 0.28, 0.3768, 471, 929, 321
42, 1300, 0.4, 0.377692307692, 491, 975, 325
42, 1350, 0.32, 0.375555555556, 507, 1022, 328
42, 1400, 0.34, 0.374285714286, 524, 1067, 333
42, 1450, 0.34, 0.373103448276, 541, 1105, 345
42, 1500, 0.32, 0.371333333333, 557, 1135, 365
42, 1550, 0.46, 0.374193548387, 580, 1171, 379
42, 1600, 0.46, 0.376875, 603, 1211, 389
42, 1650, 0.4, 0.377575757576, 623, 1251, 399
42, 1700, 0.46, 0.38, 646, 1295, 405
42, 1750, 0.36, 0.379428571429, 664, 1340, 410
42, 1800, 0.52, 0.383333333333, 690, 1383, 417
42, 1850, 0.24, 0.379459459459, 702, 1422, 428
42, 1900, 0.3, 0.377368421053, 717, 1465, 435
42, 1950, 0.38, 0.377435897436, 736, 1511, 439
42, 2000, 0.26, 0.3745, 749, 1555, 445
43, 50, 0.36, 0.36, 18, 26, 24
43, 100, 0.48, 0.42, 42, 46, 54
43, 150, 0.36, 0.4, 60, 71, 79
43, 200, 0.34, 0.385, 77, 91, 109
43, 250, 0.4, 0.388, 97, 113, 137
43, 300, 0.36, 0.383333333333, 115, 136, 164
43, 350, 0.34, 0.377142857143, 132, 163, 187
43, 400, 0.34, 0.3725, 149, 187, 213
43, 450, 0.38, 0.373333333333, 168, 202, 248
43, 500, 0.44, 0.38, 190, 210, 290
43, 550, 0.38, 0.38, 209, 216, 334
43, 600, 0.24, 0.368333333333, 221, 217, 383
43, 650, 0.56, 0.383076923077, 249, 217, 433
43, 700, 0.34, 0.38, 266, 218, 482
43, 750, 0.24, 0.370666666667, 278, 219, 531
43, 800, 0.36, 0.37, 296, 220, 580
43, 850, 0.36, 0.369411764706, 314, 222, 628
43, 900, 0.36, 0.368888888889, 332, 223, 677
43, 950, 0.28, 0.364210526316, 346, 224, 726
43, 1000, 0.46, 0.369, 369, 225, 775
43, 1050, 0.28, 0.364761904762, 383, 228, 822
43, 1100, 0.42, 0.367272727273, 404, 230, 870
43, 1150, 0.34, 0.366086956522, 421, 231, 919
43, 1200, 0.42, 0.368333333333, 442, 233, 967
43, 1250, 0.38, 0.3688, 461, 235, 1015
43, 1300, 0.36, 0.368461538462, 479, 237, 1063
43, 1350, 0.36, 0.368148148148, 497, 240, 1110
43, 1400, 0.4, 0.369285714286, 517, 241, 1159
43, 1450, 0.38, 0.369655172414, 536, 243, 1207
43, 1500, 0.4, 0.370666666667, 556, 246, 1254
43, 1550, 0.32, 0.369032258065, 572, 246, 1304
43, 1600, 0.36, 0.36875, 590, 246, 1354
43, 1650, 0.34, 0.367878787879, 607, 246, 1404
43, 1700, 0.46, 0.370588235294, 630, 246, 1454
43, 1750, 0.28, 0.368, 644, 246, 1504
43, 1800, 0.38, 0.368333333333, 663, 247, 1553
43, 1850, 0.46, 0.370810810811, 686, 247, 1603
43, 1900, 0.42, 0.372105263158, 707, 247, 1653
43, 1950, 0.5, 0.375384615385, 732, 247, 1703
43, 2000, 0.28, 0.373, 746, 247, 1753
44, 50, 0.44, 0.44, 22, 26, 24
44, 100, 0.38, 0.41, 41, 47, 53
44, 150, 0.34, 0.386666666667, 58, 75, 75
44, 200, 0.44, 0.4, 80, 100, 100
44, 250, 0.36, 0.392, 98, 126, 124
44, 300, 0.42, 0.396666666667, 119, 146, 154
44, 350, 0.4, 0.397142857143, 139, 165, 185
44, 400, 0.3, 0.385, 154, 194, 206
44, 450, 0.4, 0.386666666667, 174, 230, 220
44, 500, 0.34, 0.382, 191, 264, 236
44, 550, 0.54, 0.396363636364, 218, 292, 258
44, 600, 0.52, 0.406666666667, 244, 321, 279
44, 650, 0.4, 0.406153846154, 264, 345, 305
44, 700, 0.18, 0.39, 273, 373, 327
44, 750, 0.32, 0.385333333333, 289, 397, 353
44, 800, 0.32, 0.38125, 305, 412, 388
44, 850, 0.32, 0.377647058824, 321, 427, 423
44, 900, 0.54, 0.386666666667, 348, 436, 464
44, 950, 0.3, 0.382105263158, 363, 442, 508
44, 1000, 0.48, 0.387, 387, 451, 549
44, 1050, 0.42, 0.388571428571, 408, 464, 586
44, 1100, 0.46, 0.391818181818, 431, 471, 629
44, 1150, 0.38, 0.391304347826, 450, 479, 671
44, 1200, 0.48, 0.395, 474, 483, 717
44, 1250, 0.26, 0.3896, 487, 486, 764
44, 1300, 0.4, 0.39, 507, 493, 807
44, 1350, 0.5, 0.394074074074, 532, 499, 851
44, 1400, 0.38, 0.393571428571, 551, 499, 901
44, 1450, 0.38, 0.393103448276, 570, 504, 946
44, 1500, 0.48, 0.396, 594, 506, 994
44, 1550, 0.48, 0.398709677419, 618, 507, 1043
44, 1600, 0.46, 0.400625, 641, 508, 1092
44, 1650, 0.36, 0.399393939394, 659, 508, 1142
44, 1700, 0.32, 0.397058823529, 675, 510, 1190
44, 1750, 0.28, 0.393714285714, 689, 511, 1239
44, 1800, 0.4, 0.393888888889, 709, 516, 1284
44, 1850, 0.4, 0.394054054054, 729, 519, 1331
44, 1900, 0.42, 0.394736842105, 750, 521, 1379
44, 1950, 0.4, 0.394871794872, 770, 522, 1428
44, 2000, 0.38, 0.3945, 789, 523, 1477
45, 50, 0.56, 0.56, 28, 29, 21
45, 100, 0.3, 0.43, 43, 56, 44
45, 150, 0.44, 0.433333333333, 65, 81, 69
45, 200, 0.38, 0.42, 84, 104, 96
45, 250, 0.4, 0.416, 104, 130, 120
45, 300, 0.26, 0.39, 117, 157, 143
45, 350, 0.4, 0.391428571429, 137, 180, 170
45, 400, 0.34, 0.385, 154, 206, 194
45, 450, 0.42, 0.388888888889, 175, 223, 227
45, 500, 0.38, 0.388, 194, 236, 264
45, 550, 0.48, 0.396363636364, 218, 249, 301
45, 600, 0.4, 0.396666666667, 238, 257, 343
45, 650, 0.4, 0.396923076923, 258, 265, 385
45, 700, 0.34, 0.392857142857, 275, 271, 429
45, 750, 0.4, 0.393333333333, 295, 275, 475
45, 800, 0.58, 0.405, 324, 275, 525
45, 850, 0.44, 0.407058823529, 346, 277, 573
45, 900, 0.22, 0.396666666667, 357, 279, 621
45, 950, 0.36, 0.394736842105, 375, 284, 666
45, 1000, 0.32, 0.391, 391, 289, 711
45, 1050, 0.38, 0.390476190476, 410, 290, 760
45, 1100, 0.36, 0.389090909091, 428, 293, 807
45, 1150, 0.32, 0.386086956522, 444, 296, 854
45, 1200, 0.48, 0.39, 468, 300, 900
45, 1250, 0.34, 0.388, 485, 305, 945
45, 1300, 0.4, 0.388461538462, 505, 306, 994
45, 1350, 0.36, 0.387407407407, 523, 311, 1039
45, 1400, 0.32, 0.385, 539, 315, 1085
45, 1450, 0.46, 0.387586206897, 562, 320, 1130
45, 1500, 0.44, 0.389333333333, 584, 322, 1178
45, 1550, 0.34, 0.387741935484, 601, 331, 1219
45, 1600, 0.44, 0.389375, 623, 334, 1266
45, 1650, 0.48, 0.392121212121, 647, 334, 1316
45, 1700, 0.44, 0.393529411765, 669, 336, 1364
45, 1750, 0.4, 0.393714285714, 689, 337, 1413
45, 1800, 0.4, 0.393888888889, 709, 338, 1462
45, 1850, 0.4, 0.394054054054, 729, 340, 1510
45, 1900, 0.46, 0.395789473684, 752, 341, 1559
45, 1950, 0.4, 0.395897435897, 772, 341, 1609
45, 2000, 0.4, 0.396, 792, 344, 1656
46, 50, 0.32, 0.32, 16, 22, 28
46, 100, 0.46, 0.39, 39, 52, 48
46, 150, 0.32, 0.366666666667, 55, 78, 72
46, 200, 0.5, 0.4, 80, 101, 99
46, 250, 0.34, 0.388, 97, 127, 123
46, 300, 0.56, 0.416666666667, 125, 150, 150
46, 350, 0.46, 0.422857142857, 148, 174, 176
46, 400, 0.3, 0.4075, 163, 198, 202
46, 450, 0.28, 0.393333333333, 177, 217, 233
46, 500, 0.36, 0.39, 195, 233, 267
46, 550, 0.42, 0.392727272727, 216, 244, 306
46, 600, 0.34, 0.388333333333, 233, 260, 340
46, 650, 0.38, 0.387692307692, 252, 278, 372
46, 700, 0.38, 0.387142857143, 271, 303, 397
46, 750, 0.4, 0.388, 291, 341, 409
46, 800, 0.52, 0.39625, 317, 387, 413
46, 850, 0.34, 0.392941176471, 334, 416, 434
46, 900, 0.32, 0.388888888889, 350, 444, 456
46, 950, 0.48, 0.393684210526, 374, 475, 475
46, 1000, 0.34, 0.391, 391, 511, 489
46, 1050, 0.52, 0.397142857143, 417, 545, 505
46, 1100, 0.52, 0.402727272727, 443, 587, 513
46, 1150, 0.46, 0.405217391304, 466, 633, 517
46, 1200, 0.32, 0.401666666667, 482, 681, 519
46, 1250, 0.5, 0.4056, 507, 727, 523
46, 1300, 0.36, 0.403846153846, 525, 776, 524
46, 1350, 0.36, 0.402222222222, 543, 823, 527
46, 1400, 0.44, 0.403571428571, 565, 871, 529
46, 1450, 0.32, 0.400689655172, 581, 910, 540
46, 1500, 0.3, 0.397333333333, 596, 948, 552
46, 1550, 0.34, 0.395483870968, 613, 980, 570
46, 1600, 0.48, 0.398125, 637, 1007, 593
46, 1650, 0.28, 0.394545454545, 651, 1037, 613
46, 1700, 0.34, 0.392941176471, 668, 1069, 631
46, 1750, 0.5, 0.396, 693, 1098, 652
46, 1800, 0.52, 0.399444444444, 719, 1131, 669
46, 1850, 0.4, 0.399459459459, 739, 1168, 682
46, 1900, 0.52, 0.402631578947, 765, 1208, 692
46, 1950, 0.22, 0.397948717949, 776, 1245, 705
46, 2000, 0.38, 0.3975, 795, 1282, 718
47, 50, 0.4, 0.4, 20, 25, 25
47, 100, 0.52, 0.46, 46, 50, 50
47, 150, 0.48, 0.466666666667, 70, 76, 74
47, 200, 0.44, 0.46, 92, 101, 99
47, 250, 0.36, 0.44, 110, 130, 120
47, 300, 0.38, 0.43, 129, 155, 145
47, 350, 0.32, 0.414285714286, 145, 185, 165
47, 400, 0.42, 0.415, 166, 206, 194
47, 450, 0.36, 0.408888888889, 184, 226, 224
47, 500, 0.3, 0.398, 199, 253, 247
47, 550, 0.44, 0.401818181818, 221, 279, 271
47, 600, 0.38, 0.4, 240, 312, 288
47, 650, 0.38, 0.398461538462, 259, 327, 323
47, 700, 0.38, 0.397142857143, 278, 340, 360
47, 750, 0.36, 0.394666666667, 296, 353, 397
47, 800, 0.34, 0.39125, 313, 369, 431
47, 850, 0.4, 0.391764705882, 333, 383, 467
47, 900, 0.26, 0.384444444444, 346, 403, 497
47, 950, 0.42, 0.386315789474, 367, 430, 520
47, 1000, 0.46, 0.39, 390, 458, 542
47, 1050, 0.34, 0.387619047619, 407, 475, 575
47, 1100, 0.38, 0.387272727273, 426, 495, 605
47, 1150, 0.32, 0.384347826087, 442, 510, 640
47, 1200, 0.42, 0.385833333333, 463, 528, 672
47, 1250, 0.38, 0.3856, 482, 552, 698
47, 1300, 0.38, 0.385384615385, 501, 572, 728
47, 1350, 0.34, 0.383703703704, 518, 599, 751
47, 1400, 0.34, 0.382142857143, 535, 618, 782
47, 1450, 0.4, 0.38275862069, 555, 643, 807
47, 1500, 0.34, 0.381333333333, 572, 669, 831
47, 1550, 0.38, 0.381290322581, 591, 690, 860
47, 1600, 0.24, 0.376875, 603, 715, 885
47, 1650, 0.42, 0.378181818182, 624, 739, 911
47, 1700, 0.42, 0.379411764706, 645, 759, 941
47, 1750, 0.36, 0.378857142857, 663, 783, 967
47, 1800, 0.24, 0.375, 675, 812, 988
47, 1850, 0.36, 0.374594594595, 693, 837, 1013
47, 1900, 0.3, 0.372631578947, 708, 867, 1033
47, 1950, 0.3, 0.370769230769, 723, 902, 1048
47, 2000, 0.4, 0.3715, 743, 932, 1068
48, 50, 0.38, 0.38, 19, 20, 30
48, 100, 0.42, 0.4, 40, 45, 55
48, 150, 0.3, 0.366666666667, 55, 71, 79
48, 200, 0.4, 0.375, 75, 96, 104
48, 250, 0.36, 0.372, 93, 123, 127
48, 300, 0.4, 0.376666666667, 113, 147, 153
48, 350, 0.3, 0.365714285714, 128, 174, 176
48, 400, 0.28, 0.355, 142, 205, 195
48, 450, 0.46, 0.366666666667, 165, 244, 206
48, 500, 0.48, 0.378, 189, 286, 214
48, 550, 0.32, 0.372727272727, 205, 329, 221
48, 600, 0.32, 0.368333333333, 221, 366, 234
48, 650, 0.46, 0.375384615385, 244, 404, 246
48, 700, 0.52, 0.385714285714, 270, 438, 262
48, 750, 0.4, 0.386666666667, 290, 457, 293
48, 800, 0.38, 0.38625, 309, 491, 309
48, 850, 0.28, 0.38, 323, 526, 324
48, 900, 0.44, 0.383333333333, 345, 557, 343
48, 950, 0.38, 0.383157894737, 364, 579, 371
48, 1000, 0.36, 0.382, 382, 596, 404
48, 1050, 0.46, 0.385714285714, 405, 609, 441
48, 1100, 0.4, 0.386363636364, 425, 616, 484
48, 1150, 0.36, 0.385217391304, 443, 623, 527
48, 1200, 0.5, 0.39, 468, 628, 572
48, 1250, 0.32, 0.3872, 484, 640, 610
48, 1300, 0.42, 0.388461538462, 505, 644, 656
48, 1350, 0.46, 0.391111111111, 528, 653, 697
48, 1400, 0.38, 0.390714285714, 547, 658, 742
48, 1450, 0.32, 0.388275862069, 563, 672, 778
48, 1500, 0.48, 0.391333333333, 587, 679, 821
48, 1550, 0.36, 0.390322580645, 605, 685, 865
48, 1600, 0.44, 0.391875, 627, 690, 910
48, 1650, 0.4, 0.392121212121, 647, 696, 954
48, 1700, 0.4, 0.392352941176, 667, 702, 998
48, 1750, 0.48, 0.394857142857, 691, 708, 1042
48, 1800, 0.38, 0.394444444444, 710, 715, 1085
48, 1850, 0.28, 0.391351351351, 724, 719, 1131
48, 1900, 0.42, 0.392105263158, 745, 721, 1179
48, 1950, 0.34, 0.390769230769, 762, 723, 1227
48, 2000, 0.4, 0.391, 782, 727, 1273
49, 50, 0.34, 0.34, 17, 23, 27
49, 100, 0.42, 0.38, 38, 47, 53
49, 150, 0.42, 0.393333333333, 59, 71, 79
49, 200, 0.3, 0.37, 74, 95, 105
49, 250, 0.38, 0.372, 93, 118, 132
49, 300, 0.34, 0.366666666667, 110, 140, 160
49, 350, 0.42, 0.374285714286, 131, 162, 188
49, 400, 0.46, 0.385, 154, 188, 212
49, 450, 0.38, 0.384444444444, 173, 210, 240
49, 500, 0.52, 0.398, 199, 228, 272
49, 550, 0.42, 0.4, 220, 236, 314
49, 600, 0.48, 0.406666666667, 244, 242, 358
49, 650, 0.38, 0.404615384615, 263, 249, 401
49, 700, 0.36, 0.401428571429, 281, 254, 446
49, 750, 0.3, 0.394666666667, 296, 261, 489
49, 800, 0.4, 0.395, 316, 267, 533
49, 850, 0.44, 0.397647058824, 338, 278, 572
49, 900, 0.48, 0.402222222222, 362, 286, 614
49, 950, 0.28, 0.395789473684, 376, 294, 656
49, 1000, 0.38, 0.395, 395, 303, 697
49, 1050, 0.34, 0.392380952381, 412, 314, 736
49, 1100, 0.36, 0.390909090909, 430, 327, 773
49, 1150, 0.4, 0.391304347826, 450, 334, 816
49, 1200, 0.44, 0.393333333333, 472, 340, 860
49, 1250, 0.4, 0.3936, 492, 348, 902
49, 1300, 0.38, 0.393076923077, 511, 357, 943
49, 1350, 0.5, 0.397037037037, 536, 360, 990
49, 1400, 0.5, 0.400714285714, 561, 363, 1037
49, 1450, 0.34, 0.398620689655, 578, 363, 1087
49, 1500, 0.36, 0.397333333333, 596, 364, 1136
49, 1550, 0.44, 0.398709677419, 618, 365, 1185
49, 1600, 0.4, 0.39875, 638, 368, 1232
49, 1650, 0.34, 0.39696969697, 655, 369, 1281
49, 1700, 0.42, 0.397647058824, 676, 370, 1330
49, 1750, 0.44, 0.398857142857, 698, 372, 1378
49, 1800, 0.44, 0.4, 720, 372, 1428
49, 1850, 0.42, 0.400540540541, 741, 374, 1476
49, 1900, 0.4, 0.400526315789, 761, 378, 1522
49, 1950, 0.44, 0.401538461538, 783, 382, 1568
49, 2000, 0.28, 0.3985, 797, 384, 1616
50, 50, 0.36, 0.36, 18, 27, 23
50, 100, 0.3, 0.33, 33, 48, 52
50, 150, 0.4, 0.353333333333, 53, 72, 78
50, 200, 0.42, 0.37, 74, 96, 104
50, 250, 0.38, 0.372, 93, 111, 139
50, 300, 0.32, 0.363333333333, 109, 133, 167
50, 350, 0.46, 0.377142857143, 132, 160, 190
50, 400, 0.38, 0.3775, 151, 188, 212
50, 450, 0.34, 0.373333333333, 168, 216, 234
50, 500, 0.36, 0.372, 186, 244, 256
50, 550, 0.38, 0.372727272727, 205, 262, 288
50, 600, 0.26, 0.363333333333, 218, 277, 323
50, 650, 0.4, 0.366153846154, 238, 290, 360
50, 700, 0.44, 0.371428571429, 260, 304, 396
50, 750, 0.44, 0.376, 282, 314, 436
50, 800, 0.4, 0.3775, 302, 319, 481
50, 850, 0.42, 0.38, 323, 322, 528
50, 900, 0.52, 0.387777777778, 349, 330, 570
50, 950, 0.42, 0.389473684211, 370, 331, 619
50, 1000, 0.48, 0.394, 394, 334, 666
50, 1050, 0.3, 0.389523809524, 409, 335, 715
50, 1100, 0.44, 0.391818181818, 431, 336, 764
50, 1150, 0.46, 0.394782608696, 454, 338, 812
50, 1200, 0.42, 0.395833333333, 475, 341, 859
50, 1250, 0.46, 0.3984, 498, 344, 906
50, 1300, 0.3, 0.394615384615, 513, 348, 952
50, 1350, 0.42, 0.395555555556, 534, 349, 1001
50, 1400, 0.52, 0.4, 560, 351, 1049
50, 1450, 0.52, 0.404137931034, 586, 354, 1096
50, 1500, 0.5, 0.407333333333, 611, 354, 1146
50, 1550, 0.42, 0.407741935484, 632, 355, 1195
50, 1600, 0.4, 0.4075, 652, 356, 1244
50, 1650, 0.34, 0.405454545455, 669, 358, 1292
50, 1700, 0.22, 0.4, 680, 358, 1342
50, 1750, 0.38, 0.399428571429, 699, 358, 1392
50, 1800, 0.48, 0.401666666667, 723, 358, 1442
50, 1850, 0.32, 0.399459459459, 739, 360, 1490
50, 1900, 0.42, 0.4, 760, 365, 1535
50, 1950, 0.4, 0.4, 780, 370, 1580
50, 2000, 0.4, 0.4, 800, 375, 1625
51, 50, 0.36, 0.36, 18, 23, 27
51, 100, 0.34, 0.35, 35, 45, 55
51, 150, 0.34, 0.346666666667, 52, 72, 78
51, 200, 0.34, 0.345, 69, 92, 108
51, 250, 0.46, 0.368, 92, 113, 137
51, 300, 0.38, 0.37, 111, 136, 164
51, 350, 0.34, 0.365714285714, 128, 160, 190
51, 400, 0.4, 0.37, 148, 191, 209
51, 450, 0.36, 0.368888888889, 166, 234, 216
51, 500, 0.44, 0.376, 188, 278, 222
51, 550, 0.34, 0.372727272727, 205, 326, 224
51, 600, 0.34, 0.37, 222, 373, 227
51, 650, 0.42, 0.373846153846, 243, 419, 231
51, 700, 0.48, 0.381428571429, 267, 464, 236
51, 750, 0.3, 0.376, 282, 513, 237
51, 800, 0.42, 0.37875, 303, 557, 243
51, 850, 0.44, 0.382352941176, 325, 605, 245
51, 900, 0.28, 0.376666666667, 339, 653, 247
51, 950, 0.42, 0.378947368421, 360, 701, 249
51, 1000, 0.36, 0.378, 378, 751, 249
51, 1050, 0.42, 0.38, 399, 799, 251
51, 1100, 0.38, 0.38, 418, 849, 251
51, 1150, 0.42, 0.381739130435, 439, 896, 254
51, 1200, 0.36, 0.380833333333, 457, 945, 255
51, 1250, 0.42, 0.3824, 478, 993, 257
51, 1300, 0.48, 0.386153846154, 502, 1043, 257
51, 1350, 0.44, 0.388148148148, 524, 1091, 259
51, 1400, 0.46, 0.390714285714, 547, 1141, 259
51, 1450, 0.34, 0.388965517241, 564, 1190, 260
51, 1500, 0.46, 0.391333333333, 587, 1238, 262
51, 1550, 0.22, 0.385806451613, 598, 1287, 263
51, 1600, 0.34, 0.384375, 615, 1337, 263
51, 1650, 0.4, 0.384848484848, 635, 1386, 264
51, 1700, 0.36, 0.384117647059, 653, 1434, 266
51, 1750, 0.32, 0.382285714286, 669, 1482, 268
51, 1800, 0.42, 0.383333333333, 690, 1531, 269
51, 1850, 0.32, 0.381621621622, 706, 1579, 271
51, 1900, 0.36, 0.381052631579, 724, 1627, 273
51, 1950, 0.36, 0.380512820513, 742, 1675, 275
51, 2000, 0.44, 0.382, 764, 1722, 278
52, 50, 0.36, 0.36, 18, 25, 25
52, 100, 0.44, 0.4, 40, 50, 50
52, 150, 0.44, 0.413333333333, 62, 73, 77
52, 200, 0.38, 0.405, 81, 99, 101
52, 250, 0.46, 0.416, 104, 126, 124
52, 300, 0.42, 0.416666666667, 125, 146, 154
52, 350, 0.28, 0.397142857143, 139, 168, 182
52, 400, 0.38, 0.395, 158, 187, 213
52, 450, 0.44, 0.4, 180, 199, 251
52, 500, 0.48, 0.408, 204, 206, 294
52, 550, 0.54, 0.42, 231, 210, 340
52, 600, 0.44, 0.421666666667, 253, 212, 388
52, 650, 0.3, 0.412307692308, 268, 213, 437
52, 700, 0.3, 0.404285714286, 283, 218, 482
52, 750, 0.3, 0.397333333333, 298, 225, 525
52, 800, 0.34, 0.39375, 315, 235, 565
52, 850, 0.44, 0.396470588235, 337, 238, 612
52, 900, 0.36, 0.394444444444, 355, 245, 655
52, 950, 0.44, 0.396842105263, 377, 246, 704
52, 1000, 0.48, 0.401, 401, 252, 748
52, 1050, 0.34, 0.398095238095, 418, 259, 791
52, 1100, 0.48, 0.401818181818, 442, 259, 841
52, 1150, 0.36, 0.4, 460, 263, 887
52, 1200, 0.34, 0.3975, 477, 267, 933
52, 1250, 0.6, 0.4056, 507, 269, 981
52, 1300, 0.4, 0.405384615385, 527, 272, 1028
52, 1350, 0.48, 0.408148148148, 551, 273, 1077
52, 1400, 0.5, 0.411428571429, 576, 274, 1126
52, 1450, 0.44, 0.412413793103, 598, 275, 1175
52, 1500, 0.34, 0.41, 615, 275, 1225
52, 1550, 0.4, 0.409677419355, 635, 275, 1275
52, 1600, 0.44, 0.410625, 657, 276, 1324
52, 1650, 0.52, 0.413939393939, 683, 276, 1374
52, 1700, 0.46, 0.415294117647, 706, 276, 1424
52, 1750, 0.36, 0.413714285714, 724, 276, 1474
52, 1800, 0.38, 0.412777777778, 743, 278, 1522
52, 1850, 0.42, 0.412972972973, 764, 278, 1572
52, 1900, 0.44, 0.413684210526, 786, 279, 1621
52, 1950, 0.34, 0.411794871795, 803, 280, 1670
52, 2000, 0.46, 0.413, 826, 282, 1718
53, 50, 0.42, 0.42, 21, 24, 26
53, 100, 0.32, 0.37, 37, 58, 42
53, 150, 0.4, 0.38, 57, 82, 68
53, 200, 0.28, 0.355, 71, 101, 99
53, 250, 0.46, 0.376, 94, 128, 122
53, 300, 0.34, 0.37, 111, 150, 150
53, 350, 0.56, 0.397142857143, 139, 173, 177
53, 400, 0.34, 0.39, 156, 197, 203
53, 450, 0.5, 0.402222222222, 181, 210, 240
53, 500, 0.34, 0.396, 198, 217, 283
53, 550, 0.3, 0.387272727273, 213, 219, 331
53, 600, 0.42, 0.39, 234, 222, 378
53, 650, 0.34, 0.386153846154, 251, 226, 424
53, 700, 0.52, 0.395714285714, 277, 230, 470
53, 750, 0.4, 0.396, 297, 234, 516
53, 800, 0.24, 0.38625, 309, 237, 563
53, 850, 0.28, 0.38, 323, 240, 610
53, 900, 0.48, 0.385555555556, 347, 243, 657
53, 950, 0.48, 0.390526315789, 371, 243, 707
53, 1000, 0.32, 0.387, 387, 243, 757
53, 1050, 0.36, 0.385714285714, 405, 243, 807
53, 1100, 0.34, 0.383636363636, 422, 245, 855
53, 1150, 0.3, 0.38, 437, 250, 900
53, 1200, 0.34, 0.378333333333, 454, 255, 945
53, 1250, 0.52, 0.384, 480, 258, 992
53, 1300, 0.34, 0.382307692308, 497, 263, 1037
53, 1350, 0.42, 0.383703703704, 518, 268, 1082
53, 1400, 0.36, 0.382857142857, 536, 273, 1127
53, 1450, 0.32, 0.380689655172, 552, 276, 1174
53, 1500, 0.3, 0.378, 567, 285, 1215
53, 1550, 0.42, 0.37935483871, 588, 289, 1261
53, 1600, 0.46, 0.381875, 611, 295, 1305
53, 1650, 0.38, 0.381818181818, 630, 299, 1351
53, 1700, 0.4, 0.382352941176, 650, 305, 1395
53, 1750, 0.52, 0.386285714286, 676, 309, 1441
53, 1800, 0.38, 0.386111111111, 695, 313, 1487
53, 1850, 0.36, 0.385405405405, 713, 317, 1533
53, 1900, 0.3, 0.383157894737, 728, 321, 1579
53, 1950, 0.34, 0.382051282051, 745, 326, 1624
53, 2000, 0.48, 0.3845, 769, 332, 1668
54, 50, 0.44, 0.44, 22, 22, 28
54, 100, 0.3, 0.37, 37, 46, 54
54, 150, 0.4, 0.38, 57, 72, 78
54, 200, 0.34, 0.37, 74, 92, 108
54, 250, 0.34, 0.364, 91, 116, 134
54, 300, 0.34, 0.36, 108, 140, 160
54, 350, 0.44, 0.371428571429, 130, 162, 188
54, 400, 0.38, 0.3725, 149, 190, 210
54, 450, 0.5, 0.386666666667, 174, 206, 244
54, 500, 0.48, 0.396, 198, 220, 280
54, 550, 0.32, 0.389090909091, 214, 228, 322
54, 600, 0.28, 0.38, 228, 235, 365
54, 650, 0.38, 0.38, 247, 247, 403
54, 700, 0.44, 0.384285714286, 269, 262, 438
54, 750, 0.4, 0.385333333333, 289, 278, 472
54, 800, 0.32, 0.38125, 305, 292, 508
54, 850, 0.58, 0.392941176471, 334, 300, 550
54, 900, 0.38, 0.392222222222, 353, 300, 600
54, 950, 0.38, 0.391578947368, 372, 301, 649
54, 1000, 0.4, 0.392, 392, 303, 697
54, 1050, 0.4, 0.392380952381, 412, 304, 746
54, 1100, 0.46, 0.395454545455, 435, 310, 790
54, 1150, 0.38, 0.394782608696, 454, 310, 840
54, 1200, 0.34, 0.3925, 471, 312, 888
54, 1250, 0.54, 0.3984, 498, 317, 933
54, 1300, 0.42, 0.399230769231, 519, 319, 981
54, 1350, 0.4, 0.399259259259, 539, 321, 1029
54, 1400, 0.46, 0.401428571429, 562, 321, 1079
54, 1450, 0.44, 0.40275862069, 584, 321, 1129
54, 1500, 0.38, 0.402, 603, 321, 1179
54, 1550, 0.48, 0.404516129032, 627, 322, 1228
54, 1600, 0.46, 0.40625, 650, 322, 1278
54, 1650, 0.42, 0.406666666667, 671, 324, 1326
54, 1700, 0.44, 0.407647058824, 693, 325, 1375
54, 1750, 0.42, 0.408, 714, 325, 1425
54, 1800, 0.38, 0.407222222222, 733, 325, 1475
54, 1850, 0.44, 0.408108108108, 755, 326, 1524
54, 1900, 0.32, 0.405789473684, 771, 326, 1574
54, 1950, 0.38, 0.405128205128, 790, 327, 1623
54, 2000, 0.42, 0.4055, 811, 327, 1673
55, 50, 0.46, 0.46, 23, 30, 20
55, 100, 0.36, 0.41, 41, 54, 46
55, 150, 0.38, 0.4, 60, 83, 67
55, 200, 0.46, 0.415, 83, 114, 86
55, 250, 0.36, 0.404, 101, 138, 112
55, 300, 0.42, 0.406666666667, 122, 159, 141
55, 350, 0.4, 0.405714285714, 142, 184, 166
55, 400, 0.34, 0.3975, 159, 209, 191
55, 450, 0.44, 0.402222222222, 181, 223, 227
55, 500, 0.36, 0.398, 199, 234, 266
55, 550, 0.36, 0.394545454545, 217, 243, 307
55, 600, 0.48, 0.401666666667, 241, 250, 350
55, 650, 0.36, 0.398461538462, 259, 257, 393
55, 700, 0.32, 0.392857142857, 275, 263, 437
55, 750, 0.42, 0.394666666667, 296, 267, 483
55, 800, 0.46, 0.39875, 319, 269, 531
55, 850, 0.36, 0.396470588235, 337, 282, 568
55, 900, 0.42, 0.397777777778, 358, 289, 611
55, 950, 0.54, 0.405263157895, 385, 299, 651
55, 1000, 0.24, 0.397, 397, 306, 694
55, 1050, 0.3, 0.392380952381, 412, 318, 732
55, 1100, 0.44, 0.394545454545, 434, 324, 776
55, 1150, 0.22, 0.386956521739, 445, 332, 818
55, 1200, 0.34, 0.385, 462, 340, 860
55, 1250, 0.36, 0.384, 480, 348, 902
55, 1300, 0.3, 0.380769230769, 495, 358, 942
55, 1350, 0.34, 0.379259259259, 512, 361, 989
55, 1400, 0.38, 0.379285714286, 531, 365, 1035
55, 1450, 0.26, 0.375172413793, 544, 373, 1077
55, 1500, 0.38, 0.375333333333, 563, 385, 1115
55, 1550, 0.38, 0.375483870968, 582, 395, 1155
55, 1600, 0.36, 0.375, 600, 407, 1193
55, 1650, 0.32, 0.373333333333, 616, 412, 1238
55, 1700, 0.28, 0.370588235294, 630, 420, 1280
55, 1750, 0.34, 0.369714285714, 647, 430, 1320
55, 1800, 0.42, 0.371111111111, 668, 442, 1358
55, 1850, 0.34, 0.37027027027, 685, 455, 1395
55, 1900, 0.28, 0.367894736842, 699, 469, 1431
55, 1950, 0.34, 0.367179487179, 716, 484, 1466
55, 2000, 0.54, 0.3715, 743, 496, 1504
56, 50, 0.58, 0.58, 29, 22, 28
56, 100, 0.32, 0.45, 45, 43, 57
56, 150, 0.32, 0.406666666667, 61, 69, 81
56, 200, 0.5, 0.43, 86, 92, 108
56, 250, 0.36, 0.416, 104, 111, 139
56, 300, 0.42, 0.416666666667, 125, 139, 161
56, 350, 0.48, 0.425714285714, 149, 162, 188
56, 400, 0.46, 0.43, 172, 187, 213
56, 450, 0.32, 0.417777777778, 188, 204, 246
56, 500, 0.32, 0.408, 204, 214, 286
56, 550, 0.46, 0.412727272727, 227, 220, 330
56, 600, 0.4, 0.411666666667, 247, 225, 375
56, 650, 0.34, 0.406153846154, 264, 229, 421
56, 700, 0.42, 0.407142857143, 285, 231, 469
56, 750, 0.38, 0.405333333333, 304, 233, 517
56, 800, 0.34, 0.40125, 321, 235, 565
56, 850, 0.5, 0.407058823529, 346, 237, 613
56, 900, 0.46, 0.41, 369, 239, 661
56, 950, 0.5, 0.414736842105, 394, 240, 710
56, 1000, 0.38, 0.413, 413, 241, 759
56, 1050, 0.4, 0.412380952381, 433, 242, 808
56, 1100, 0.34, 0.409090909091, 450, 249, 851
56, 1150, 0.44, 0.410434782609, 472, 255, 895
56, 1200, 0.44, 0.411666666667, 494, 261, 939
56, 1250, 0.34, 0.4088, 511, 262, 988
56, 1300, 0.42, 0.409230769231, 532, 267, 1033
56, 1350, 0.42, 0.40962962963, 553, 273, 1077
56, 1400, 0.44, 0.410714285714, 575, 277, 1123
56, 1450, 0.4, 0.410344827586, 595, 288, 1162
56, 1500, 0.32, 0.407333333333, 611, 293, 1207
56, 1550, 0.36, 0.405806451613, 629, 300, 1250
56, 1600, 0.44, 0.406875, 651, 310, 1290
56, 1650, 0.46, 0.408484848485, 674, 317, 1333
56, 1700, 0.38, 0.407647058824, 693, 327, 1373
56, 1750, 0.42, 0.408, 714, 335, 1415
56, 1800, 0.36, 0.406666666667, 732, 346, 1454
56, 1850, 0.38, 0.405945945946, 751, 356, 1494
56, 1900, 0.28, 0.402631578947, 765, 367, 1533
56, 1950, 0.34, 0.401025641026, 782, 374, 1576
56, 2000, 0.56, 0.405, 810, 379, 1621
57, 50, 0.32, 0.32, 16, 25, 25
57, 100, 0.48, 0.4, 40, 58, 42
57, 150, 0.36, 0.386666666667, 58, 79, 71
57, 200, 0.42, 0.395, 79, 101, 99
57, 250, 0.36, 0.388, 97, 118, 132
57, 300, 0.32, 0.376666666667, 113, 145, 155
57, 350, 0.36, 0.374285714286, 131, 170, 180
57, 400, 0.38, 0.375, 150, 190, 210
57, 450, 0.4, 0.377777777778, 170, 211, 239
57, 500, 0.56, 0.396, 198, 228, 272
57, 550, 0.4, 0.396363636364, 218, 244, 306
57, 600, 0.26, 0.385, 231, 263, 337
57, 650, 0.36, 0.383076923077, 249, 281, 369
57, 700, 0.48, 0.39, 273, 293, 407
57, 750, 0.44, 0.393333333333, 295, 296, 454
57, 800, 0.4, 0.39375, 315, 300, 500
57, 850, 0.46, 0.397647058824, 338, 307, 543
57, 900, 0.32, 0.393333333333, 354, 308, 592
57, 950, 0.4, 0.393684210526, 374, 316, 634
57, 1000, 0.42, 0.395, 395, 321, 679
57, 1050, 0.56, 0.402857142857, 423, 322, 728
57, 1100, 0.44, 0.404545454545, 445, 324, 776
57, 1150, 0.32, 0.400869565217, 461, 324, 826
57, 1200, 0.44, 0.4025, 483, 328, 872
57, 1250, 0.38, 0.4016, 502, 333, 917
57, 1300, 0.44, 0.403076923077, 524, 335, 965
57, 1350, 0.3, 0.399259259259, 539, 335, 1015
57, 1400, 0.46, 0.401428571429, 562, 338, 1062
57, 1450, 0.36, 0.4, 580, 339, 1111
57, 1500, 0.34, 0.398, 597, 342, 1158
57, 1550, 0.42, 0.398709677419, 618, 347, 1203
57, 1600, 0.34, 0.396875, 635, 347, 1253
57, 1650, 0.28, 0.393333333333, 649, 351, 1299
57, 1700, 0.38, 0.392941176471, 668, 352, 1348
57, 1750, 0.42, 0.393714285714, 689, 354, 1396
57, 1800, 0.36, 0.392777777778, 707, 356, 1444
57, 1850, 0.38, 0.392432432432, 726, 359, 1491
57, 1900, 0.44, 0.393684210526, 748, 360, 1540
57, 1950, 0.38, 0.393333333333, 767, 362, 1588
57, 2000, 0.48, 0.3955, 791, 363, 1637
58, 50, 0.44, 0.44, 22, 34, 16
58, 100, 0.44, 0.44, 44, 56, 44
58, 150, 0.34, 0.406666666667, 61, 83, 67
58, 200, 0.26, 0.37, 74, 115, 85
58, 250, 0.34, 0.364, 91, 138, 112
58, 300, 0.34, 0.36, 108, 172, 128
58, 350, 0.46, 0.374285714286, 131, 197, 153
58, 400, 0.44, 0.3825, 153, 215, 185
58, 450, 0.54, 0.4, 180, 223, 227
58, 500, 0.4, 0.4, 200, 224, 276
58, 550, 0.46, 0.405454545455, 223, 225, 325
58, 600, 0.32, 0.398333333333, 239, 226, 374
58, 650, 0.44, 0.401538461538, 261, 228, 422
58, 700, 0.4, 0.401428571429, 281, 230, 470
58, 750, 0.44, 0.404, 303, 232, 518
58, 800, 0.54, 0.4125, 330, 234, 566
58, 850, 0.28, 0.404705882353, 344, 237, 613
58, 900, 0.36, 0.402222222222, 362, 241, 659
58, 950, 0.38, 0.401052631579, 381, 248, 702
58, 1000, 0.5, 0.406, 406, 251, 749
58, 1050, 0.4, 0.405714285714, 426, 254, 796
58, 1100, 0.46, 0.408181818182, 449, 254, 846
58, 1150, 0.34, 0.405217391304, 466, 255, 895
58, 1200, 0.4, 0.405, 486, 258, 942
58, 1250, 0.42, 0.4056, 507, 262, 988
58, 1300, 0.38, 0.404615384615, 526, 263, 1037
58, 1350, 0.4, 0.404444444444, 546, 268, 1082
58, 1400, 0.52, 0.408571428571, 572, 272, 1128
58, 1450, 0.28, 0.404137931034, 586, 274, 1176
58, 1500, 0.46, 0.406, 609, 274, 1226
58, 1550, 0.38, 0.405161290323, 628, 276, 1274
58, 1600, 0.42, 0.405625, 649, 278, 1322
58, 1650, 0.44, 0.406666666667, 671, 279, 1371
58, 1700, 0.44, 0.407647058824, 693, 280, 1420
58, 1750, 0.42, 0.408, 714, 285, 1465
58, 1800, 0.34, 0.406111111111, 731, 289, 1511
58, 1850, 0.24, 0.401621621622, 743, 292, 1558
58, 1900, 0.38, 0.401052631579, 762, 294, 1606
58, 1950, 0.46, 0.402564102564, 785, 298, 1652
58, 2000, 0.44, 0.4035, 807, 304, 1696
59, 50, 0.46, 0.46, 23, 24, 26
59, 100, 0.2, 0.33, 33, 45, 55
59, 150, 0.32, 0.326666666667, 49, 64, 86
59, 200, 0.46, 0.36, 72, 91, 109
59, 250, 0.4, 0.368, 92, 118, 132
59, 300, 0.48, 0.386666666667, 116, 142, 158
59, 350, 0.34, 0.38, 133, 165, 185
59, 400, 0.28, 0.3675, 147, 188, 212
59, 450, 0.42, 0.373333333333, 168, 204, 246
59, 500, 0.3, 0.366, 183, 213, 287
59, 550, 0.42, 0.370909090909, 204, 221, 329
59, 600, 0.44, 0.376666666667, 226, 234, 366
59, 650, 0.34, 0.373846153846, 243, 239, 411
59, 700, 0.54, 0.385714285714, 270, 243, 457
59, 750, 0.38, 0.385333333333, 289, 248, 502
59, 800, 0.36, 0.38375, 307, 252, 548
59, 850, 0.36, 0.382352941176, 325, 255, 595
59, 900, 0.5, 0.388888888889, 350, 256, 644
59, 950, 0.4, 0.389473684211, 370, 259, 691
59, 1000, 0.48, 0.394, 394, 259, 741
59, 1050, 0.42, 0.395238095238, 415, 259, 791
59, 1100, 0.4, 0.395454545455, 435, 259, 841
59, 1150, 0.44, 0.397391304348, 457, 260, 890
59, 1200, 0.4, 0.3975, 477, 261, 939
59, 1250, 0.42, 0.3984, 498, 261, 989
59, 1300, 0.4, 0.398461538462, 518, 261, 1039
59, 1350, 0.36, 0.397037037037, 536, 262, 1088
59, 1400, 0.42, 0.397857142857, 557, 262, 1138
59, 1450, 0.42, 0.398620689655, 578, 262, 1188
59, 1500, 0.32, 0.396, 594, 264, 1236
59, 1550, 0.42, 0.396774193548, 615, 265, 1285
59, 1600, 0.32, 0.394375, 631, 267, 1333
59, 1650, 0.34, 0.392727272727, 648, 271, 1379
59, 1700, 0.48, 0.395294117647, 672, 275, 1425
59, 1750, 0.44, 0.396571428571, 694, 277, 1473
59, 1800, 0.34, 0.395, 711, 280, 1520
59, 1850, 0.46, 0.396756756757, 734, 284, 1566
59, 1900, 0.3, 0.394210526316, 749, 285, 1615
59, 1950, 0.32, 0.392307692308, 765, 288, 1662
59, 2000, 0.38, 0.392, 784, 288, 1712
60, 50, 0.34, 0.34, 17, 25, 25
60, 100, 0.32, 0.33, 33, 52, 48
60, 150, 0.4, 0.353333333333, 53, 84, 66
60, 200, 0.36, 0.355, 71, 110, 90
60, 250, 0.4, 0.364, 91, 143, 107
60, 300, 0.38, 0.366666666667, 110, 166, 134
60, 350, 0.38, 0.368571428571, 129, 187, 163
60, 400, 0.46, 0.38, 152, 213, 187
60, 450, 0.44, 0.386666666667, 174, 235, 215
60, 500, 0.34, 0.382, 191, 265, 235
60, 550, 0.26, 0.370909090909, 204, 291, 259
60, 600, 0.44, 0.376666666667, 226, 316, 284
60, 650, 0.56, 0.390769230769, 254, 342, 308
60, 700, 0.28, 0.382857142857, 268, 371, 329
60, 750, 0.28, 0.376, 282, 398, 352
60, 800, 0.42, 0.37875, 303, 423, 377
60, 850, 0.24, 0.370588235294, 315, 456, 394
60, 900, 0.4, 0.372222222222, 335, 486, 414
60, 950, 0.5, 0.378947368421, 360, 511, 439
60, 1000, 0.42, 0.381, 381, 536, 464
60, 1050, 0.36, 0.38, 399, 551, 499
60, 1100, 0.26, 0.374545454545, 412, 575, 525
60, 1150, 0.36, 0.373913043478, 430, 599, 551
60, 1200, 0.44, 0.376666666667, 452, 613, 587
60, 1250, 0.5, 0.3816, 477, 625, 625
60, 1300, 0.38, 0.381538461538, 496, 640, 660
60, 1350, 0.36, 0.380740740741, 514, 652, 698
60, 1400, 0.46, 0.383571428571, 537, 666, 734
60, 1450, 0.28, 0.38, 551, 679, 771
60, 1500, 0.46, 0.382666666667, 574, 690, 810
60, 1550, 0.34, 0.381290322581, 591, 704, 846
60, 1600, 0.42, 0.3825, 612, 714, 886
60, 1650, 0.42, 0.383636363636, 633, 719, 931
60, 1700, 0.26, 0.38, 646, 726, 974
60, 1750, 0.42, 0.381142857143, 667, 733, 1017
60, 1800, 0.42, 0.382222222222, 688, 735, 1065
60, 1850, 0.42, 0.383243243243, 709, 738, 1112
60, 1900, 0.32, 0.381578947368, 725, 750, 1150
60, 1950, 0.5, 0.384615384615, 750, 762, 1188
60, 2000, 0.52, 0.388, 776, 768, 1232
61, 50, 0.42, 0.42, 21, 25, 25
61, 100, 0.36, 0.39, 39, 48, 52
61, 150, 0.36, 0.38, 57, 69, 81
61, 200, 0.36, 0.375, 75, 99, 101
61, 250, 0.44, 0.388, 97, 120, 130
61, 300, 0.26, 0.366666666667, 110, 144, 156
61, 350, 0.32, 0.36, 126, 169, 181
61, 400, 0.36, 0.36, 144, 192, 208
61, 450, 0.26, 0.348888888889, 157, 211, 239
61, 500, 0.44, 0.358, 179, 218, 282
61, 550, 0.26, 0.349090909091, 192, 221, 329
61, 600, 0.42, 0.355, 213, 221, 379
61, 650, 0.42, 0.36, 234, 223, 427
61, 700, 0.4, 0.362857142857, 254, 224, 476
61, 750, 0.28, 0.357333333333, 268, 226, 524
61, 800, 0.42, 0.36125, 289, 226, 574
61, 850, 0.28, 0.356470588235, 303, 227, 623
61, 900, 0.42, 0.36, 324, 228, 672
61, 950, 0.42, 0.363157894737, 345, 230, 720
61, 1000, 0.32, 0.361, 361, 232, 768
61, 1050, 0.54, 0.369523809524, 388, 234, 816
61, 1100, 0.4, 0.370909090909, 408, 234, 866
61, 1150, 0.52, 0.377391304348, 434, 234, 916
61, 1200, 0.42, 0.379166666667, 455, 234, 966
61, 1250, 0.34, 0.3776, 472, 236, 1014
61, 1300, 0.42, 0.379230769231, 493, 236, 1064
61, 1350, 0.48, 0.382962962963, 517, 236, 1114
61, 1400, 0.36, 0.382142857143, 535, 237, 1163
61, 1450, 0.5, 0.386206896552, 560, 238, 1212
61, 1500, 0.42, 0.387333333333, 581, 240, 1260
61, 1550, 0.4, 0.387741935484, 601, 240, 1310
61, 1600, 0.26, 0.38375, 614, 242, 1358
61, 1650, 0.38, 0.383636363636, 633, 242, 1408
61, 1700, 0.48, 0.386470588235, 657, 242, 1458
61, 1750, 0.34, 0.385142857143, 674, 243, 1507
61, 1800, 0.36, 0.384444444444, 692, 243, 1557
61, 1850, 0.42, 0.385405405405, 713, 243, 1607
61, 1900, 0.3, 0.383157894737, 728, 243, 1657
61, 1950, 0.58, 0.388205128205, 757, 243, 1707
61, 2000, 0.42, 0.389, 778, 243, 1757
62, 50, 0.36, 0.36, 18, 19, 31
62, 100, 0.42, 0.39, 39, 45, 55
62, 150, 0.4, 0.393333333333, 59, 69, 81
62, 200, 0.36, 0.385, 77, 95, 105
62, 250, 0.42, 0.392, 98, 124, 126
62, 300, 0.46, 0.403333333333, 121, 146, 154
62, 350, 0.24, 0.38, 133, 172, 178
62, 400, 0.44, 0.3875, 155, 199, 201
62, 450, 0.38, 0.386666666667, 174, 215, 235
62, 500, 0.44, 0.392, 196, 220, 280
62, 550, 0.46, 0.398181818182, 219, 223, 327
62, 600, 0.34, 0.393333333333, 236, 227, 373
62, 650, 0.38, 0.392307692308, 255, 231, 419
62, 700, 0.32, 0.387142857143, 271, 238, 462
62, 750, 0.58, 0.4, 300, 240, 510
62, 800, 0.38, 0.39875, 319, 240, 560
62, 850, 0.48, 0.403529411765, 343, 241, 609
62, 900, 0.44, 0.405555555556, 365, 241, 659
62, 950, 0.34, 0.402105263158, 382, 241, 709
62, 1000, 0.36, 0.4, 400, 241, 759
62, 1050, 0.52, 0.405714285714, 426, 241, 809
62, 1100, 0.32, 0.401818181818, 442, 241, 859
62, 1150, 0.42, 0.402608695652, 463, 241, 909
62, 1200, 0.38, 0.401666666667, 482, 242, 958
62, 1250, 0.54, 0.4072, 509, 242, 1008
62, 1300, 0.46, 0.409230769231, 532, 242, 1058
62, 1350, 0.4, 0.408888888889, 552, 242, 1108
62, 1400, 0.28, 0.404285714286, 566, 242, 1158
62, 1450, 0.36, 0.40275862069, 584, 242, 1208
62, 1500, 0.38, 0.402, 603, 242, 1258
62, 1550, 0.48, 0.404516129032, 627, 242, 1308
62, 1600, 0.44, 0.405625, 649, 242, 1358
62, 1650, 0.44, 0.406666666667, 671, 242, 1408
62, 1700, 0.42, 0.407058823529, 692, 242, 1458
62, 1750, 0.4, 0.406857142857, 712, 242, 1508
62, 1800, 0.54, 0.410555555556, 739, 242, 1558
62, 1850, 0.44, 0.411351351351, 761, 242, 1608
62, 1900, 0.34, 0.409473684211, 778, 242, 1658
62, 1950, 0.46, 0.410769230769, 801, 242, 1708
62, 2000, 0.42, 0.411, 822, 242, 1758
63, 50, 0.34, 0.34, 17, 20, 30
63, 100, 0.38, 0.36, 36, 45, 55
63, 150, 0.32, 0.346666666667, 52, 67, 83
63, 200, 0.34, 0.345, 69, 96, 104
63, 250, 0.4, 0.356, 89, 125, 125
63, 300, 0.4, 0.363333333333, 109, 146, 154
63, 350, 0.4, 0.368571428571, 129, 170, 180
63, 400, 0.44, 0.3775, 151, 194, 206
63, 450, 0.44, 0.384444444444, 173, 203, 247
63, 500, 0.36, 0.382, 191, 211, 289
63, 550, 0.32, 0.376363636364, 207, 216, 334
63, 600, 0.46, 0.383333333333, 230, 223, 377
63, 650, 0.38, 0.383076923077, 249, 227, 423
63, 700, 0.46, 0.388571428571, 272, 230, 470
63, 750, 0.38, 0.388, 291, 231, 519
63, 800, 0.4, 0.38875, 311, 232, 568
63, 850, 0.38, 0.388235294118, 330, 233, 617
63, 900, 0.46, 0.392222222222, 353, 235, 665
63, 950, 0.46, 0.395789473684, 376, 235, 715
63, 1000, 0.42, 0.397, 397, 237, 763
63, 1050, 0.46, 0.4, 420, 237, 813
63, 1100, 0.46, 0.402727272727, 443, 237, 863
63, 1150, 0.42, 0.40347826087, 464, 238, 912
63, 1200, 0.32, 0.4, 480, 239, 961
63, 1250, 0.32, 0.3968, 496, 242, 1008
63, 1300, 0.32, 0.393846153846, 512, 245, 1055
63, 1350, 0.5, 0.397777777778, 537, 246, 1104
63, 1400, 0.3, 0.394285714286, 552, 248, 1152
63, 1450, 0.36, 0.393103448276, 570, 249, 1201
63, 1500, 0.38, 0.392666666667, 589, 252, 1248
63, 1550, 0.42, 0.393548387097, 610, 254, 1296
63, 1600, 0.48, 0.39625, 634, 254, 1346
63, 1650, 0.28, 0.392727272727, 648, 256, 1394
63, 1700, 0.5, 0.395882352941, 673, 257, 1443
63, 1750, 0.5, 0.398857142857, 698, 257, 1493
63, 1800, 0.36, 0.397777777778, 716, 258, 1542
63, 1850, 0.44, 0.398918918919, 738, 260, 1590
63, 1900, 0.3, 0.396315789474, 753, 262, 1638
63, 1950, 0.34, 0.394871794872, 770, 264, 1686
63, 2000, 0.42, 0.3955, 791, 266, 1734
64, 50, 0.42, 0.42, 21, 28, 22
64, 100, 0.36, 0.39, 39, 58, 42
64, 150, 0.38, 0.386666666667, 58, 82, 68
64, 200, 0.42, 0.395, 79, 107, 93
64, 250, 0.38, 0.392, 98, 134, 116
64, 300, 0.34, 0.383333333333, 115, 158, 142
64, 350, 0.46, 0.394285714286, 138, 187, 163
64, 400, 0.34, 0.3875, 155, 211, 189
64, 450, 0.54, 0.404444444444, 182, 240, 210
64, 500, 0.36, 0.4, 200, 280, 220
64, 550, 0.42, 0.401818181818, 221, 314, 236
64, 600, 0.42, 0.403333333333, 242, 350, 250
64, 650, 0.4, 0.403076923077, 262, 383, 267
64, 700, 0.38, 0.401428571429, 281, 412, 288
64, 750, 0.34, 0.397333333333, 298, 431, 319
64, 800, 0.4, 0.3975, 318, 449, 351
64, 850, 0.38, 0.396470588235, 337, 466, 384
64, 900, 0.3, 0.391111111111, 352, 486, 414
64, 950, 0.44, 0.393684210526, 374, 501, 449
64, 1000, 0.46, 0.397, 397, 523, 477
64, 1050, 0.28, 0.391428571429, 411, 547, 503
64, 1100, 0.26, 0.385454545455, 424, 575, 525
64, 1150, 0.38, 0.385217391304, 443, 597, 553
64, 1200, 0.34, 0.383333333333, 460, 628, 572
64, 1250, 0.48, 0.3872, 484, 657, 593
64, 1300, 0.38, 0.386923076923, 503, 678, 622
64, 1350, 0.44, 0.388888888889, 525, 702, 648
64, 1400, 0.24, 0.383571428571, 537, 735, 665
64, 1450, 0.42, 0.384827586207, 558, 766, 684
64, 1500, 0.38, 0.384666666667, 577, 794, 706
64, 1550, 0.34, 0.383225806452, 594, 821, 729
64, 1600, 0.3, 0.380625, 609, 858, 742
64, 1650, 0.32, 0.378787878788, 625, 886, 764
64, 1700, 0.24, 0.374705882353, 637, 914, 786
64, 1750, 0.4, 0.375428571429, 657, 942, 808
64, 1800, 0.4, 0.376111111111, 677, 958, 842
64, 1850, 0.42, 0.377297297297, 698, 986, 864
64, 1900, 0.46, 0.379473684211, 721, 1003, 897
64, 1950, 0.48, 0.382051282051, 745, 1018, 932
64, 2000, 0.38, 0.382, 764, 1037, 963
65, 50, 0.32, 0.32, 16, 25, 25
65, 100, 0.36, 0.34, 34, 51, 49
65, 150, 0.32, 0.333333333333, 50, 78, 72
65, 200, 0.32, 0.33, 66, 106, 94
65, 250, 0.3, 0.324, 81, 137, 113
65, 300, 0.38, 0.333333333333, 100, 168, 132
65, 350, 0.34, 0.334285714286, 117, 192, 158
65, 400, 0.36, 0.3375, 135, 211, 189
65, 450, 0.48, 0.353333333333, 159, 217, 233
65, 500, 0.4, 0.358, 179, 218, 282
65, 550, 0.34, 0.356363636364, 196, 222, 328
65, 600, 0.3, 0.351666666667, 211, 225, 375
65, 650, 0.38, 0.353846153846, 230, 227, 423
65, 700, 0.44, 0.36, 252, 227, 473
65, 750, 0.52, 0.370666666667, 278, 228, 522
65, 800, 0.46, 0.37625, 301, 231, 569
65, 850, 0.42, 0.378823529412, 322, 231, 619
65, 900, 0.56, 0.388888888889, 350, 231, 669
65, 950, 0.3, 0.384210526316, 365, 231, 719
65, 1000, 0.42, 0.386, 386, 234, 766
65, 1050, 0.42, 0.387619047619, 407, 234, 816
65, 1100, 0.36, 0.386363636364, 425, 234, 866
65, 1150, 0.5, 0.391304347826, 450, 235, 915
65, 1200, 0.44, 0.393333333333, 472, 235, 965
65, 1250, 0.48, 0.3968, 496, 235, 1015
65, 1300, 0.3, 0.393076923077, 511, 235, 1065
65, 1350, 0.26, 0.388148148148, 524, 235, 1115
65, 1400, 0.5, 0.392142857143, 549, 236, 1164
65, 1450, 0.26, 0.387586206897, 562, 237, 1213
65, 1500, 0.46, 0.39, 585, 237, 1263
65, 1550, 0.38, 0.389677419355, 604, 237, 1313
65, 1600, 0.48, 0.3925, 628, 237, 1363
65, 1650, 0.5, 0.395757575758, 653, 239, 1411
65, 1700, 0.54, 0.4, 680, 239, 1461
65, 1750, 0.38, 0.399428571429, 699, 239, 1511
65, 1800, 0.38, 0.398888888889, 718, 239, 1561
65, 1850, 0.52, 0.402162162162, 744, 239, 1611
65, 1900, 0.44, 0.403157894737, 766, 239, 1661
65, 1950, 0.48, 0.405128205128, 790, 239, 1711
65, 2000, 0.38, 0.4045, 809, 240, 1760
66, 50, 0.42, 0.42, 21, 23, 27
66, 100, 0.4, 0.41, 41, 44, 56
66, 150, 0.34, 0.386666666667, 58, 66, 84
66, 200, 0.5, 0.415, 83, 93, 107
66, 250, 0.38, 0.408, 102, 122, 128
66, 300, 0.44, 0.413333333333, 124, 150, 150
66, 350, 0.42, 0.414285714286, 145, 168, 182
66, 400, 0.4, 0.4125, 165, 189, 211
66, 450, 0.38, 0.408888888889, 184, 220, 230
66, 500, 0.36, 0.404, 202, 263, 237
66, 550, 0.26, 0.390909090909, 215, 305, 245
66, 600, 0.24, 0.378333333333, 227, 338, 262
66, 650, 0.44, 0.383076923077, 249, 368, 282
66, 700, 0.44, 0.387142857143, 271, 401, 299
66, 750, 0.34, 0.384, 288, 433, 317
66, 800, 0.48, 0.39, 312, 465, 335
66, 850, 0.34, 0.387058823529, 329, 488, 362
66, 900, 0.38, 0.386666666667, 348, 513, 387
66, 950, 0.46, 0.390526315789, 371, 530, 420
66, 1000, 0.32, 0.387, 387, 548, 452
66, 1050, 0.32, 0.38380952381, 403, 572, 478
66, 1100, 0.4, 0.384545454545, 423, 602, 498
66, 1150, 0.34, 0.382608695652, 440, 627, 523
66, 1200, 0.34, 0.380833333333, 457, 657, 543
66, 1250, 0.42, 0.3824, 478, 691, 559
66, 1300, 0.4, 0.383076923077, 498, 729, 571
66, 1350, 0.28, 0.379259259259, 512, 757, 593
66, 1400, 0.34, 0.377857142857, 529, 793, 607
66, 1450, 0.38, 0.377931034483, 548, 824, 626
66, 1500, 0.34, 0.376666666667, 565, 860, 640
66, 1550, 0.32, 0.374838709677, 581, 888, 662
66, 1600, 0.46, 0.3775, 604, 918, 682
66, 1650, 0.44, 0.379393939394, 626, 947, 703
66, 1700, 0.42, 0.380588235294, 647, 969, 731
66, 1750, 0.42, 0.381714285714, 668, 983, 767
66, 1800, 0.4, 0.382222222222, 688, 995, 805
66, 1850, 0.52, 0.385945945946, 714, 1002, 848
66, 1900, 0.26, 0.382631578947, 727, 1011, 889
66, 1950, 0.46, 0.384615384615, 750, 1022, 928
66, 2000, 0.34, 0.3835, 767, 1031, 969
67, 50, 0.34, 0.34, 17, 27, 23
67, 100, 0.28, 0.31, 31, 52, 48
67, 150, 0.32, 0.313333333333, 47, 72, 78
67, 200, 0.3, 0.31, 62, 98, 102
67, 250, 0.4, 0.328, 82, 122, 128
67, 300, 0.38, 0.336666666667, 101, 143, 157
67, 350, 0.42, 0.348571428571, 122, 166, 184
67, 400, 0.4, 0.355, 142, 197, 203
67, 450, 0.4, 0.36, 162, 236, 214
67, 500, 0.46, 0.37, 185, 282, 218
67, 550, 0.46, 0.378181818182, 208, 328, 222
67, 600, 0.42, 0.381666666667, 229, 373, 227
67, 650, 0.34, 0.378461538462, 246, 422, 228
67, 700, 0.36, 0.377142857143, 264, 472, 228
67, 750, 0.48, 0.384, 288, 519, 231
67, 800, 0.3, 0.37875, 303, 567, 233
67, 850, 0.42, 0.381176470588, 324, 617, 233
67, 900, 0.42, 0.383333333333, 345, 666, 234
67, 950, 0.32, 0.38, 361, 715, 235
67, 1000, 0.42, 0.382, 382, 764, 236
67, 1050, 0.34, 0.38, 399, 812, 238
67, 1100, 0.36, 0.379090909091, 417, 860, 240
67, 1150, 0.3, 0.375652173913, 432, 908, 242
67, 1200, 0.4, 0.376666666667, 452, 956, 244
67, 1250, 0.32, 0.3744, 468, 1005, 245
67, 1300, 0.34, 0.373076923077, 485, 1054, 246
67, 1350, 0.4, 0.374074074074, 505, 1102, 248
67, 1400, 0.38, 0.374285714286, 524, 1150, 250
67, 1450, 0.36, 0.373793103448, 542, 1196, 254
67, 1500, 0.52, 0.378666666667, 568, 1246, 254
67, 1550, 0.46, 0.381290322581, 591, 1295, 255
67, 1600, 0.3, 0.37875, 606, 1344, 256
67, 1650, 0.46, 0.381212121212, 629, 1393, 257
67, 1700, 0.36, 0.380588235294, 647, 1442, 258
67, 1750, 0.4, 0.381142857143, 667, 1492, 258
67, 1800, 0.44, 0.382777777778, 689, 1541, 259
67, 1850, 0.4, 0.383243243243, 709, 1589, 261
67, 1900, 0.32, 0.381578947368, 725, 1639, 261
67, 1950, 0.42, 0.382564102564, 746, 1683, 267
67, 2000, 0.38, 0.3825, 765, 1732, 268
68, 50, 0.36, 0.36, 18, 22, 28
68, 100, 0.5, 0.43, 43, 49, 51
68, 150, 0.4, 0.42, 63, 76, 74
68, 200, 0.32, 0.395, 79, 100, 100
68, 250, 0.3, 0.376, 94, 132, 118
68, 300, 0.3, 0.363333333333, 109, 156, 144
68, 350, 0.52, 0.385714285714, 135, 183, 167
68, 400, 0.36, 0.3825, 153, 205, 195
68, 450, 0.46, 0.391111111111, 176, 228, 222
68, 500, 0.28, 0.38, 190, 246, 254
68, 550, 0.58, 0.398181818182, 219, 252, 298
68, 600, 0.44, 0.401666666667, 241, 257, 343
68, 650, 0.46, 0.406153846154, 264, 259, 391
68, 700, 0.26, 0.395714285714, 277, 264, 436
68, 750, 0.26, 0.386666666667, 290, 274, 476
68, 800, 0.36, 0.385, 308, 282, 518
68, 850, 0.4, 0.385882352941, 328, 287, 563
68, 900, 0.42, 0.387777777778, 349, 296, 604
68, 950, 0.36, 0.386315789474, 367, 304, 646
68, 1000, 0.36, 0.385, 385, 315, 685
68, 1050, 0.4, 0.385714285714, 405, 324, 726
68, 1100, 0.4, 0.386363636364, 425, 337, 763
68, 1150, 0.38, 0.386086956522, 444, 354, 796
68, 1200, 0.36, 0.385, 462, 368, 832
68, 1250, 0.38, 0.3848, 481, 381, 869
68, 1300, 0.42, 0.386153846154, 502, 389, 911
68, 1350, 0.36, 0.385185185185, 520, 398, 952
68, 1400, 0.38, 0.385, 539, 404, 996
68, 1450, 0.44, 0.386896551724, 561, 408, 1042
68, 1500, 0.32, 0.384666666667, 577, 417, 1083
68, 1550, 0.36, 0.383870967742, 595, 426, 1124
68, 1600, 0.56, 0.389375, 623, 432, 1168
68, 1650, 0.44, 0.390909090909, 645, 442, 1208
68, 1700, 0.44, 0.392352941176, 667, 447, 1253
68, 1750, 0.46, 0.394285714286, 690, 451, 1299
68, 1800, 0.46, 0.396111111111, 713, 460, 1340
68, 1850, 0.3, 0.393513513514, 728, 465, 1385
68, 1900, 0.42, 0.394210526316, 749, 468, 1432
68, 1950, 0.42, 0.394871794872, 770, 471, 1479
68, 2000, 0.34, 0.3935, 787, 473, 1527
69, 50, 0.3, 0.3, 15, 27, 23
69, 100, 0.52, 0.41, 41, 60, 40
69, 150, 0.5, 0.44, 66, 85, 65
69, 200, 0.36, 0.42, 84, 107, 93
69, 250, 0.34, 0.404, 101, 134, 116
69, 300, 0.5, 0.42, 126, 161, 139
69, 350, 0.42, 0.42, 147, 186, 164
69, 400, 0.36, 0.4125, 165, 209, 191
69, 450, 0.34, 0.404444444444, 182, 225, 225
69, 500, 0.26, 0.39, 195, 238, 262
69, 550, 0.38, 0.389090909091, 214, 248, 302
69, 600, 0.42, 0.391666666667, 235, 258, 342
69, 650, 0.44, 0.395384615385, 257, 264, 386
69, 700, 0.24, 0.384285714286, 269, 272, 428
69, 750, 0.46, 0.389333333333, 292, 280, 470
69, 800, 0.4, 0.39, 312, 295, 505
69, 850, 0.38, 0.389411764706, 331, 306, 544
69, 900, 0.4, 0.39, 351, 316, 584
69, 950, 0.38, 0.389473684211, 370, 327, 623
69, 1000, 0.42, 0.391, 391, 344, 656
69, 1050, 0.42, 0.392380952381, 412, 356, 694
69, 1100, 0.46, 0.395454545455, 435, 375, 725
69, 1150, 0.34, 0.393043478261, 452, 392, 758
69, 1200, 0.36, 0.391666666667, 470, 408, 792
69, 1250, 0.38, 0.3912, 489, 421, 829
69, 1300, 0.44, 0.393076923077, 511, 430, 870
69, 1350, 0.32, 0.39037037037, 527, 446, 904
69, 1400, 0.36, 0.389285714286, 545, 457, 943
69, 1450, 0.46, 0.391724137931, 568, 468, 982
69, 1500, 0.4, 0.392, 588, 481, 1019
69, 1550, 0.36, 0.390967741935, 606, 494, 1056
69, 1600, 0.52, 0.395, 632, 513, 1087
69, 1650, 0.42, 0.395757575758, 653, 524, 1126
69, 1700, 0.36, 0.394705882353, 671, 529, 1171
69, 1750, 0.42, 0.395428571429, 692, 534, 1216
69, 1800, 0.3, 0.392777777778, 707, 544, 1256
69, 1850, 0.38, 0.392432432432, 726, 552, 1298
69, 1900, 0.36, 0.391578947368, 744, 563, 1337
69, 1950, 0.44, 0.392820512821, 766, 571, 1379
69, 2000, 0.36, 0.392, 784, 573, 1427
70, 50, 0.38, 0.38, 19, 27, 23
70, 100, 0.4, 0.39, 39, 57, 43
70, 150, 0.32, 0.366666666667, 55, 79, 71
70, 200, 0.38, 0.37, 74, 101, 99
70, 250, 0.3, 0.356, 89, 131, 119
70, 300, 0.32, 0.35, 105, 154, 146
70, 350, 0.46, 0.365714285714, 128, 180, 170
70, 400, 0.44, 0.375, 150, 202, 198
70, 450, 0.32, 0.368888888889, 166, 213, 237
70, 500, 0.5, 0.382, 191, 216, 284
70, 550, 0.4, 0.383636363636, 211, 217, 333
70, 600, 0.32, 0.378333333333, 227, 217, 383
70, 650, 0.42, 0.381538461538, 248, 219, 431
70, 700, 0.46, 0.387142857143, 271, 219, 481
70, 750, 0.38, 0.386666666667, 290, 224, 526
70, 800, 0.32, 0.3825, 306, 225, 575
70, 850, 0.58, 0.394117647059, 335, 227, 623
70, 900, 0.42, 0.395555555556, 356, 228, 672
70, 950, 0.38, 0.394736842105, 375, 229, 721
70, 1000, 0.4, 0.395, 395, 229, 771
70, 1050, 0.48, 0.399047619048, 419, 229, 821
70, 1100, 0.28, 0.393636363636, 433, 230, 870
70, 1150, 0.44, 0.395652173913, 455, 231, 919
70, 1200, 0.5, 0.4, 480, 231, 969
70, 1250, 0.44, 0.4016, 502, 232, 1018
70, 1300, 0.52, 0.406153846154, 528, 232, 1068
70, 1350, 0.32, 0.402962962963, 544, 232, 1118
70, 1400, 0.34, 0.400714285714, 561, 232, 1168
70, 1450, 0.48, 0.403448275862, 585, 232, 1218
70, 1500, 0.34, 0.401333333333, 602, 232, 1268
70, 1550, 0.28, 0.397419354839, 616, 233, 1317
70, 1600, 0.4, 0.3975, 636, 233, 1367
70, 1650, 0.38, 0.39696969697, 655, 233, 1417
70, 1700, 0.42, 0.397647058824, 676, 233, 1467
70, 1750, 0.48, 0.4, 700, 233, 1517
70, 1800, 0.36, 0.398888888889, 718, 233, 1567
70, 1850, 0.36, 0.397837837838, 736, 233, 1617
70, 1900, 0.38, 0.397368421053, 755, 233, 1667
70, 1950, 0.36, 0.39641025641, 773, 233, 1717
70, 2000, 0.28, 0.3935, 787, 233, 1767
71, 50, 0.36, 0.36, 18, 22, 28
71, 100, 0.5, 0.43, 43, 45, 55
71, 150, 0.54, 0.466666666667, 70, 67, 83
71, 200, 0.38, 0.445, 89, 88, 112
71, 250, 0.38, 0.432, 108, 117, 133
71, 300, 0.3, 0.41, 123, 145, 155
71, 350, 0.42, 0.411428571429, 144, 164, 186
71, 400, 0.52, 0.425, 170, 194, 206
71, 450, 0.42, 0.424444444444, 191, 216, 234
71, 500, 0.52, 0.434, 217, 240, 260
71, 550, 0.42, 0.432727272727, 238, 256, 294
71, 600, 0.4, 0.43, 258, 280, 320
71, 650, 0.42, 0.429230769231, 279, 295, 355
71, 700, 0.44, 0.43, 301, 306, 394
71, 750, 0.24, 0.417333333333, 313, 317, 433
71, 800, 0.42, 0.4175, 334, 323, 477
71, 850, 0.3, 0.410588235294, 349, 333, 517
71, 900, 0.42, 0.411111111111, 370, 349, 551
71, 950, 0.5, 0.415789473684, 395, 356, 594
71, 1000, 0.36, 0.413, 413, 368, 632
71, 1050, 0.48, 0.41619047619, 437, 378, 672
71, 1100, 0.48, 0.419090909091, 461, 383, 717
71, 1150, 0.4, 0.418260869565, 481, 392, 758
71, 1200, 0.38, 0.416666666667, 500, 405, 795
71, 1250, 0.4, 0.416, 520, 412, 838
71, 1300, 0.34, 0.413076923077, 537, 424, 876
71, 1350, 0.28, 0.408148148148, 551, 438, 912
71, 1400, 0.36, 0.406428571429, 569, 449, 951
71, 1450, 0.36, 0.404827586207, 587, 462, 988
71, 1500, 0.4, 0.404666666667, 607, 474, 1026
71, 1550, 0.46, 0.406451612903, 630, 482, 1068
71, 1600, 0.44, 0.4075, 652, 485, 1115
71, 1650, 0.36, 0.406060606061, 670, 491, 1159
71, 1700, 0.36, 0.404705882353, 688, 504, 1196
71, 1750, 0.38, 0.404, 707, 511, 1239
71, 1800, 0.46, 0.405555555556, 730, 517, 1283
71, 1850, 0.38, 0.404864864865, 749, 525, 1325
71, 1900, 0.34, 0.403157894737, 766, 531, 1369
71, 1950, 0.36, 0.402051282051, 784, 538, 1412
71, 2000, 0.48, 0.404, 808, 542, 1458
72, 50, 0.42, 0.42, 21, 17, 33
72, 100, 0.36, 0.39, 39, 41, 59
72, 150, 0.4, 0.393333333333, 59, 70, 80
72, 200, 0.34, 0.38, 76, 92, 108
72, 250, 0.44, 0.392, 98, 116, 134
72, 300, 0.3, 0.376666666667, 113, 139, 161
72, 350, 0.4, 0.38, 133, 169, 181
72, 400, 0.46, 0.39, 156, 195, 205
72, 450, 0.32, 0.382222222222, 172, 214, 236
72, 500, 0.44, 0.388, 194, 232, 268
72, 550, 0.44, 0.392727272727, 216, 259, 291
72, 600, 0.42, 0.395, 237, 279, 321
72, 650, 0.4, 0.395384615385, 257, 300, 350
72, 700, 0.46, 0.4, 280, 321, 379
72, 750, 0.5, 0.406666666667, 305, 338, 412
72, 800, 0.34, 0.4025, 322, 359, 441
72, 850, 0.26, 0.394117647059, 335, 376, 474
72, 900, 0.34, 0.391111111111, 352, 398, 502
72, 950, 0.36, 0.389473684211, 370, 409, 541
72, 1000, 0.24, 0.382, 382, 424, 576
72, 1050, 0.36, 0.380952380952, 400, 448, 602
72, 1100, 0.42, 0.382727272727, 421, 475, 625
72, 1150, 0.36, 0.381739130435, 439, 500, 650
72, 1200, 0.42, 0.383333333333, 460, 526, 674
72, 1250, 0.42, 0.3848, 481, 559, 691
72, 1300, 0.32, 0.382307692308, 497, 592, 708
72, 1350, 0.32, 0.38, 513, 618, 732
72, 1400, 0.4, 0.380714285714, 533, 641, 759
72, 1450, 0.38, 0.380689655172, 552, 661, 789
72, 1500, 0.44, 0.382666666667, 574, 694, 806
72, 1550, 0.44, 0.384516129032, 596, 720, 830
72, 1600, 0.48, 0.3875, 620, 756, 844
72, 1650, 0.46, 0.389696969697, 643, 794, 856
72, 1700, 0.54, 0.394117647059, 670, 832, 868
72, 1750, 0.38, 0.393714285714, 689, 877, 873
72, 1800, 0.36, 0.392777777778, 707, 918, 882
72, 1850, 0.46, 0.394594594595, 730, 965, 885
72, 1900, 0.22, 0.39, 741, 1008, 892
72, 1950, 0.3, 0.387692307692, 756, 1058, 892
72, 2000, 0.5, 0.3905, 781, 1101, 899
73, 50, 0.4, 0.4, 20, 21, 29
73, 100, 0.34, 0.37, 37, 42, 58
73, 150, 0.38, 0.373333333333, 56, 70, 80
73, 200, 0.32, 0.36, 72, 92, 108
73, 250, 0.42, 0.372, 93, 116, 134
73, 300, 0.38, 0.373333333333, 112, 140, 160
73, 350, 0.3, 0.362857142857, 127, 162, 188
73, 400, 0.38, 0.365, 146, 188, 212
73, 450, 0.4, 0.368888888889, 166, 213, 237
73, 500, 0.42, 0.374, 187, 236, 264
73, 550, 0.36, 0.372727272727, 205, 256, 294
73, 600, 0.36, 0.371666666667, 223, 268, 332
73, 650, 0.42, 0.375384615385, 244, 282, 368
73, 700, 0.26, 0.367142857143, 257, 306, 394
73, 750, 0.42, 0.370666666667, 278, 324, 426
73, 800, 0.44, 0.375, 300, 331, 469
73, 850, 0.4, 0.376470588235, 320, 349, 501
73, 900, 0.4, 0.377777777778, 340, 370, 530
73, 950, 0.52, 0.385263157895, 366, 394, 556
73, 1000, 0.4, 0.386, 386, 423, 577
73, 1050, 0.4, 0.386666666667, 406, 449, 601
73, 1100, 0.46, 0.39, 429, 471, 629
73, 1150, 0.3, 0.386086956522, 444, 498, 652
73, 1200, 0.4, 0.386666666667, 464, 531, 669
73, 1250, 0.36, 0.3856, 482, 560, 690
73, 1300, 0.44, 0.387692307692, 504, 601, 699
73, 1350, 0.56, 0.394074074074, 532, 635, 715
73, 1400, 0.5, 0.397857142857, 557, 672, 728
73, 1450, 0.42, 0.398620689655, 578, 711, 739
73, 1500, 0.42, 0.399333333333, 599, 752, 748
73, 1550, 0.44, 0.40064516129, 621, 799, 751
73, 1600, 0.36, 0.399375, 639, 840, 760
73, 1650, 0.38, 0.398787878788, 658, 881, 769
73, 1700, 0.42, 0.399411764706, 679, 916, 784
73, 1750, 0.3, 0.396571428571, 694, 949, 801
73, 1800, 0.48, 0.398888888889, 718, 985, 815
73, 1850, 0.22, 0.394054054054, 729, 1024, 826
73, 1900, 0.46, 0.395789473684, 752, 1058, 842
73, 1950, 0.34, 0.394358974359, 769, 1093, 857
73, 2000, 0.44, 0.3955, 791, 1119, 881
74, 50, 0.26, 0.26, 13, 24, 26
74, 100, 0.26, 0.26, 26, 54, 46
74, 150, 0.42, 0.313333333333, 47, 79, 71
74, 200, 0.44, 0.345, 69, 103, 97
74, 250, 0.4, 0.356, 89, 127, 123
74, 300, 0.36, 0.356666666667, 107, 153, 147
74, 350, 0.34, 0.354285714286, 124, 178, 172
74, 400, 0.3, 0.3475, 139, 201, 199
74, 450, 0.4, 0.353333333333, 159, 219, 231
74, 500, 0.24, 0.342, 171, 241, 259
74, 550, 0.34, 0.341818181818, 188, 267, 283
74, 600, 0.34, 0.341666666667, 205, 287, 313
74, 650, 0.3, 0.338461538462, 220, 297, 353
74, 700, 0.3, 0.335714285714, 235, 306, 394
74, 750, 0.46, 0.344, 258, 324, 426
74, 800, 0.34, 0.34375, 275, 339, 461
74, 850, 0.34, 0.343529411765, 292, 356, 494
74, 900, 0.24, 0.337777777778, 304, 366, 534
74, 950, 0.44, 0.343157894737, 326, 379, 571
74, 1000, 0.38, 0.345, 345, 384, 616
74, 1050, 0.44, 0.349523809524, 367, 396, 654
74, 1100, 0.58, 0.36, 396, 402, 698
74, 1150, 0.46, 0.364347826087, 419, 405, 745
74, 1200, 0.38, 0.365, 438, 408, 792
74, 1250, 0.22, 0.3592, 449, 411, 839
74, 1300, 0.36, 0.359230769231, 467, 413, 887
74, 1350, 0.36, 0.359259259259, 485, 415, 935
74, 1400, 0.46, 0.362857142857, 508, 415, 985
74, 1450, 0.42, 0.364827586207, 529, 416, 1034
74, 1500, 0.28, 0.362, 543, 421, 1079
74, 1550, 0.36, 0.361935483871, 561, 427, 1123
74, 1600, 0.46, 0.365, 584, 431, 1169
74, 1650, 0.32, 0.363636363636, 600, 438, 1212
74, 1700, 0.54, 0.368823529412, 627, 445, 1255
74, 1750, 0.42, 0.370285714286, 648, 452, 1298
74, 1800, 0.36, 0.37, 666, 458, 1342
74, 1850, 0.4, 0.370810810811, 686, 467, 1383
74, 1900, 0.24, 0.367368421053, 698, 471, 1429
74, 1950, 0.34, 0.366666666667, 715, 478, 1472
74, 2000, 0.34, 0.366, 732, 479, 1521
75, 50, 0.46, 0.46, 23, 24, 26
75, 100, 0.44, 0.45, 45, 47, 53
75, 150, 0.4, 0.433333333333, 65, 69, 81
75, 200, 0.36, 0.415, 83, 91, 109
75, 250, 0.36, 0.404, 101, 114, 136
75, 300, 0.42, 0.406666666667, 122, 135, 165
75, 350, 0.42, 0.408571428571, 143, 155, 195
75, 400, 0.38, 0.405, 162, 180, 220
75, 450, 0.36, 0.4, 180, 198, 252
75, 500, 0.44, 0.404, 202, 207, 293
75, 550, 0.44, 0.407272727273, 224, 213, 337
75, 600, 0.28, 0.396666666667, 238, 217, 383
75, 650, 0.38, 0.395384615385, 257, 219, 431
75, 700, 0.4, 0.395714285714, 277, 223, 477
75, 750, 0.42, 0.397333333333, 298, 224, 526
75, 800, 0.46, 0.40125, 321, 226, 574
75, 850, 0.44, 0.403529411765, 343, 226, 624
75, 900, 0.5, 0.408888888889, 368, 227, 673
75, 950, 0.46, 0.411578947368, 391, 227, 723
75, 1000, 0.36, 0.409, 409, 229, 771
75, 1050, 0.44, 0.410476190476, 431, 229, 821
75, 1100, 0.4, 0.41, 451, 229, 871
75, 1150, 0.5, 0.413913043478, 476, 230, 920
75, 1200, 0.4, 0.413333333333, 496, 231, 969
75, 1250, 0.42, 0.4136, 517, 231, 1019
75, 1300, 0.4, 0.413076923077, 537, 231, 1069
75, 1350, 0.52, 0.417037037037, 563, 231, 1119
75, 1400, 0.32, 0.413571428571, 579, 232, 1168
75, 1450, 0.32, 0.410344827586, 595, 232, 1218
75, 1500, 0.3, 0.406666666667, 610, 232, 1268
75, 1550, 0.42, 0.407096774194, 631, 233, 1317
75, 1600, 0.54, 0.41125, 658, 235, 1365
75, 1650, 0.28, 0.407272727273, 672, 237, 1413
75, 1700, 0.38, 0.406470588235, 691, 238, 1462
75, 1750, 0.36, 0.405142857143, 709, 240, 1510
75, 1800, 0.42, 0.405555555556, 730, 240, 1560
75, 1850, 0.52, 0.408648648649, 756, 242, 1608
75, 1900, 0.42, 0.408947368421, 777, 242, 1658
75, 1950, 0.44, 0.409743589744, 799, 243, 1707
75, 2000, 0.38, 0.409, 818, 243, 1757
76, 50, 0.42, 0.42, 21, 23, 27
76, 100, 0.42, 0.42, 42, 47, 53
76, 150, 0.4, 0.413333333333, 62, 72, 78
76, 200, 0.5, 0.435, 87, 98, 102
76, 250, 0.24, 0.396, 99, 118, 132
76, 300, 0.26, 0.373333333333, 112, 141, 159
76, 350, 0.3, 0.362857142857, 127, 165, 185
76, 400, 0.28, 0.3525, 141, 189, 211
76, 450, 0.34, 0.351111111111, 158, 208, 242
76, 500, 0.32, 0.348, 174, 221, 279
76, 550, 0.36, 0.349090909091, 192, 235, 315
76, 600, 0.36, 0.35, 210, 240, 360
76, 650, 0.44, 0.356923076923, 232, 255, 395
76, 700, 0.4, 0.36, 252, 262, 438
76, 750, 0.5, 0.369333333333, 277, 268, 482
76, 800, 0.4, 0.37125, 297, 269, 531
76, 850, 0.44, 0.375294117647, 319, 272, 578
76, 900, 0.42, 0.377777777778, 340, 274, 626
76, 950, 0.4, 0.378947368421, 360, 277, 673
76, 1000, 0.38, 0.379, 379, 280, 720
76, 1050, 0.42, 0.380952380952, 400, 288, 762
76, 1100, 0.36, 0.38, 418, 297, 803
76, 1150, 0.38, 0.38, 437, 308, 842
76, 1200, 0.4, 0.380833333333, 457, 316, 884
76, 1250, 0.46, 0.384, 480, 330, 920
76, 1300, 0.48, 0.387692307692, 504, 339, 961
76, 1350, 0.32, 0.385185185185, 520, 348, 1002
76, 1400, 0.42, 0.386428571429, 541, 358, 1042
76, 1450, 0.38, 0.386206896552, 560, 364, 1086
76, 1500, 0.44, 0.388, 582, 371, 1129
76, 1550, 0.3, 0.385161290323, 597, 373, 1177
76, 1600, 0.54, 0.39, 624, 374, 1226
76, 1650, 0.42, 0.390909090909, 645, 375, 1275
76, 1700, 0.38, 0.390588235294, 664, 382, 1318
76, 1750, 0.4, 0.390857142857, 684, 393, 1357
76, 1800, 0.38, 0.390555555556, 703, 399, 1401
76, 1850, 0.46, 0.392432432432, 726, 405, 1445
76, 1900, 0.46, 0.394210526316, 749, 409, 1491
76, 1950, 0.46, 0.395897435897, 772, 411, 1539
76, 2000, 0.26, 0.3925, 785, 414, 1586
77, 50, 0.42, 0.42, 21, 26, 24
77, 100, 0.42, 0.42, 42, 54, 46
77, 150, 0.28, 0.373333333333, 56, 69, 81
77, 200, 0.44, 0.39, 78, 92, 108
77, 250, 0.34, 0.38, 95, 119, 131
77, 300, 0.44, 0.39, 117, 144, 156
77, 350, 0.3, 0.377142857143, 132, 173, 177
77, 400, 0.5, 0.3925, 157, 199, 201
77, 450, 0.4, 0.393333333333, 177, 220, 230
77, 500, 0.34, 0.388, 194, 239, 261
77, 550, 0.36, 0.385454545455, 212, 261, 289
77, 600, 0.3, 0.378333333333, 227, 287, 313
77, 650, 0.38, 0.378461538462, 246, 314, 336
77, 700, 0.36, 0.377142857143, 264, 349, 351
77, 750, 0.44, 0.381333333333, 286, 377, 373
77, 800, 0.42, 0.38375, 307, 408, 392
77, 850, 0.34, 0.381176470588, 324, 435, 415
77, 900, 0.36, 0.38, 342, 451, 449
77, 950, 0.34, 0.377894736842, 359, 476, 474
77, 1000, 0.42, 0.38, 380, 495, 505
77, 1050, 0.36, 0.379047619048, 398, 513, 537
77, 1100, 0.44, 0.381818181818, 420, 528, 572
77, 1150, 0.5, 0.386956521739, 445, 538, 612
77, 1200, 0.26, 0.381666666667, 458, 553, 647
77, 1250, 0.34, 0.38, 475, 577, 673
77, 1300, 0.36, 0.379230769231, 493, 599, 701
77, 1350, 0.4, 0.38, 513, 612, 738
77, 1400, 0.36, 0.379285714286, 531, 630, 770
77, 1450, 0.3, 0.376551724138, 546, 645, 805
77, 1500, 0.4, 0.377333333333, 566, 662, 838
77, 1550, 0.4, 0.378064516129, 586, 681, 869
77, 1600, 0.5, 0.381875, 611, 707, 893
77, 1650, 0.36, 0.381212121212, 629, 725, 925
77, 1700, 0.36, 0.380588235294, 647, 739, 961
77, 1750, 0.36, 0.38, 665, 751, 999
77, 1800, 0.48, 0.382777777778, 689, 770, 1030
77, 1850, 0.44, 0.384324324324, 711, 786, 1064
77, 1900, 0.54, 0.388421052632, 738, 799, 1101
77, 1950, 0.36, 0.387692307692, 756, 814, 1136
77, 2000, 0.48, 0.39, 780, 825, 1175
78, 50, 0.36, 0.36, 18, 25, 25
78, 100, 0.4, 0.38, 38, 50, 50
78, 150, 0.4, 0.386666666667, 58, 69, 81
78, 200, 0.54, 0.425, 85, 91, 109
78, 250, 0.4, 0.42, 105, 116, 134
78, 300, 0.32, 0.403333333333, 121, 143, 157
78, 350, 0.42, 0.405714285714, 142, 168, 182
78, 400, 0.44, 0.41, 164, 193, 207
78, 450, 0.32, 0.4, 180, 211, 239
78, 500, 0.42, 0.402, 201, 229, 271
78, 550, 0.26, 0.389090909091, 214, 242, 308
78, 600, 0.34, 0.385, 231, 262, 338
78, 650, 0.38, 0.384615384615, 250, 276, 374
78, 700, 0.36, 0.382857142857, 268, 296, 404
78, 750, 0.36, 0.381333333333, 286, 320, 430
78, 800, 0.38, 0.38125, 305, 340, 460
78, 850, 0.26, 0.374117647059, 318, 357, 493
78, 900, 0.44, 0.377777777778, 340, 370, 530
78, 950, 0.42, 0.38, 361, 388, 562
78, 1000, 0.26, 0.374, 374, 403, 597
78, 1050, 0.5, 0.38, 399, 416, 634
78, 1100, 0.38, 0.38, 418, 429, 671
78, 1150, 0.34, 0.378260869565, 435, 442, 708
78, 1200, 0.4, 0.379166666667, 455, 457, 743
78, 1250, 0.4, 0.38, 475, 467, 783
78, 1300, 0.36, 0.379230769231, 493, 485, 815
78, 1350, 0.4, 0.38, 513, 512, 838
78, 1400, 0.4, 0.380714285714, 533, 536, 864
78, 1450, 0.44, 0.38275862069, 555, 554, 896
78, 1500, 0.42, 0.384, 576, 570, 930
78, 1550, 0.5, 0.387741935484, 601, 595, 955
78, 1600, 0.38, 0.3875, 620, 613, 987
78, 1650, 0.44, 0.389090909091, 642, 632, 1018
78, 1700, 0.38, 0.388823529412, 661, 661, 1039
78, 1750, 0.36, 0.388, 679, 683, 1067
78, 1800, 0.42, 0.388888888889, 700, 709, 1091
78, 1850, 0.38, 0.388648648649, 719, 728, 1122
78, 1900, 0.36, 0.387894736842, 737, 746, 1154
78, 1950, 0.46, 0.389743589744, 760, 765, 1185
78, 2000, 0.34, 0.3885, 777, 782, 1218
79, 50, 0.48, 0.48, 24, 24, 26
79, 100, 0.36, 0.42, 42, 49, 51
79, 150, 0.42, 0.42, 63, 70, 80
79, 200, 0.36, 0.405, 81, 100, 100
79, 250, 0.44, 0.412, 103, 119, 131
79, 300, 0.34, 0.4, 120, 141, 159
79, 350, 0.3, 0.385714285714, 135, 169, 181
79, 400, 0.38, 0.385, 154, 193, 207
79, 450, 0.32, 0.377777777778, 170, 223, 227
79, 500, 0.46, 0.386, 193, 262, 238
79, 550, 0.26, 0.374545454545, 206, 294, 256
79, 600, 0.42, 0.378333333333, 227, 325, 275
79, 650, 0.42, 0.381538461538, 248, 354, 296
79, 700, 0.36, 0.38, 266, 378, 322
79, 750, 0.44, 0.384, 288, 409, 341
79, 800, 0.32, 0.38, 304, 444, 356
79, 850, 0.38, 0.38, 323, 479, 371
79, 900, 0.38, 0.38, 342, 507, 393
79, 950, 0.44, 0.383157894737, 364, 527, 423
79, 1000, 0.32, 0.38, 380, 537, 463
79, 1050, 0.26, 0.374285714286, 393, 546, 504
79, 1100, 0.46, 0.378181818182, 416, 559, 541
79, 1150, 0.44, 0.380869565217, 438, 571, 579
79, 1200, 0.32, 0.378333333333, 454, 589, 611
79, 1250, 0.38, 0.3784, 473, 606, 644
79, 1300, 0.5, 0.383076923077, 498, 632, 668
79, 1350, 0.38, 0.382962962963, 517, 652, 698
79, 1400, 0.4, 0.383571428571, 537, 673, 727
79, 1450, 0.32, 0.381379310345, 553, 688, 762
79, 1500, 0.28, 0.378, 567, 708, 792
79, 1550, 0.34, 0.376774193548, 584, 727, 823
79, 1600, 0.38, 0.376875, 603, 747, 853
79, 1650, 0.42, 0.378181818182, 624, 763, 887
79, 1700, 0.44, 0.38, 646, 779, 921
79, 1750, 0.42, 0.381142857143, 667, 798, 952
79, 1800, 0.34, 0.38, 684, 818, 982
79, 1850, 0.36, 0.379459459459, 702, 837, 1013
79, 1900, 0.42, 0.380526315789, 723, 859, 1041
79, 1950, 0.28, 0.377948717949, 737, 870, 1080
79, 2000, 0.42, 0.379, 758, 883, 1117
80, 50, 0.46, 0.46, 23, 26, 24
80, 100, 0.46, 0.46, 46, 47, 53
80, 150, 0.36, 0.426666666667, 64, 69, 81
80, 200, 0.44, 0.43, 86, 94, 106
80, 250, 0.38, 0.42, 105, 118, 132
80, 300, 0.32, 0.403333333333, 121, 141, 159
80, 350, 0.3, 0.388571428571, 136, 166, 184
80, 400, 0.34, 0.3825, 153, 191, 209
80, 450, 0.22, 0.364444444444, 164, 207, 243
80, 500, 0.5, 0.378, 189, 229, 271
80, 550, 0.46, 0.385454545455, 212, 240, 310
80, 600, 0.34, 0.381666666667, 229, 248, 352
80, 650, 0.44, 0.386153846154, 251, 252, 398
80, 700, 0.38, 0.385714285714, 270, 261, 439
80, 750, 0.4, 0.386666666667, 290, 278, 472
80, 800, 0.34, 0.38375, 307, 290, 510
80, 850, 0.5, 0.390588235294, 332, 298, 552
80, 900, 0.44, 0.393333333333, 354, 304, 596
80, 950, 0.28, 0.387368421053, 368, 316, 634
80, 1000, 0.5, 0.393, 393, 330, 670
80, 1050, 0.42, 0.394285714286, 414, 343, 707
80, 1100, 0.32, 0.390909090909, 430, 357, 743
80, 1150, 0.42, 0.392173913043, 451, 377, 773
80, 1200, 0.44, 0.394166666667, 473, 394, 806
80, 1250, 0.44, 0.396, 495, 414, 836
80, 1300, 0.42, 0.396923076923, 516, 440, 860
80, 1350, 0.48, 0.4, 540, 466, 884
80, 1400, 0.5, 0.403571428571, 565, 494, 906
80, 1450, 0.36, 0.402068965517, 583, 524, 926
80, 1500, 0.4, 0.402, 603, 549, 951
80, 1550, 0.42, 0.402580645161, 624, 574, 976
80, 1600, 0.4, 0.4025, 644, 593, 1007
80, 1650, 0.34, 0.400606060606, 661, 610, 1040
80, 1700, 0.28, 0.397058823529, 675, 625, 1075
80, 1750, 0.38, 0.396571428571, 694, 640, 1110
80, 1800, 0.32, 0.394444444444, 710, 649, 1151
80, 1850, 0.46, 0.396216216216, 733, 666, 1184
80, 1900, 0.28, 0.393157894737, 747, 678, 1222
80, 1950, 0.46, 0.394871794872, 770, 695, 1255
80, 2000, 0.38, 0.3945, 789, 708, 1292
81, 50, 0.46, 0.46, 23, 21, 29
81, 100, 0.4, 0.43, 43, 43, 57
81, 150, 0.3, 0.386666666667, 58, 70, 80
81, 200, 0.36, 0.38, 76, 98, 102
81, 250, 0.46, 0.396, 99, 118, 132
81, 300, 0.44, 0.403333333333, 121, 146, 154
81, 350, 0.34, 0.394285714286, 138, 174, 176
81, 400, 0.5, 0.4075, 163, 196, 204
81, 450, 0.36, 0.402222222222, 181, 215, 235
81, 500, 0.42, 0.404, 202, 230, 270
81, 550, 0.26, 0.390909090909, 215, 242, 308
81, 600, 0.42, 0.393333333333, 236, 262, 338
81, 650, 0.36, 0.390769230769, 254, 287, 363
81, 700, 0.34, 0.387142857143, 271, 313, 387
81, 750, 0.38, 0.386666666667, 290, 337, 413
81, 800, 0.42, 0.38875, 311, 361, 439
81, 850, 0.4, 0.389411764706, 331, 387, 463
81, 900, 0.36, 0.387777777778, 349, 406, 494
81, 950, 0.28, 0.382105263158, 363, 426, 524
81, 1000, 0.32, 0.379, 379, 445, 555
81, 1050, 0.42, 0.380952380952, 400, 464, 586
81, 1100, 0.34, 0.379090909091, 417, 476, 624
81, 1150, 0.38, 0.379130434783, 436, 486, 664
81, 1200, 0.56, 0.386666666667, 464, 500, 700
81, 1250, 0.34, 0.3848, 481, 508, 742
81, 1300, 0.3, 0.381538461538, 496, 517, 783
81, 1350, 0.34, 0.38, 513, 527, 823
81, 1400, 0.42, 0.381428571429, 534, 543, 857
81, 1450, 0.46, 0.384137931034, 557, 552, 898
81, 1500, 0.34, 0.382666666667, 574, 557, 943
81, 1550, 0.32, 0.38064516129, 590, 566, 984
81, 1600, 0.38, 0.380625, 609, 580, 1020
81, 1650, 0.38, 0.380606060606, 628, 593, 1057
81, 1700, 0.32, 0.378823529412, 644, 608, 1092
81, 1750, 0.48, 0.381714285714, 668, 616, 1134
81, 1800, 0.28, 0.378888888889, 682, 624, 1176
81, 1850, 0.46, 0.381081081081, 705, 632, 1218
81, 1900, 0.28, 0.378421052632, 719, 642, 1258
81, 1950, 0.3, 0.37641025641, 734, 647, 1303
81, 2000, 0.48, 0.379, 758, 655, 1345
82, 50, 0.38, 0.38, 19, 25, 25
82, 100, 0.4, 0.39, 39, 52, 48
82, 150, 0.4, 0.393333333333, 59, 76, 74
82, 200, 0.46, 0.41, 82, 100, 100
82, 250, 0.44, 0.416, 104, 127, 123
82, 300, 0.4, 0.413333333333, 124, 155, 145
82, 350, 0.4, 0.411428571429, 144, 180, 170
82, 400, 0.4, 0.41, 164, 203, 197
82, 450, 0.44, 0.413333333333, 186, 218, 232
82, 500, 0.34, 0.406, 203, 225, 275
82, 550, 0.48, 0.412727272727, 227, 234, 316
82, 600, 0.48, 0.418333333333, 251, 239, 361
82, 650, 0.32, 0.410769230769, 267, 247, 403
82, 700, 0.42, 0.411428571429, 288, 257, 443
82, 750, 0.4, 0.410666666667, 308, 264, 486
82, 800, 0.42, 0.41125, 329, 281, 519
82, 850, 0.44, 0.412941176471, 351, 292, 558
82, 900, 0.34, 0.408888888889, 368, 300, 600
82, 950, 0.42, 0.409473684211, 389, 307, 643
82, 1000, 0.44, 0.411, 411, 317, 683
82, 1050, 0.46, 0.413333333333, 434, 323, 727
82, 1100, 0.4, 0.412727272727, 454, 336, 764
82, 1150, 0.3, 0.407826086957, 469, 344, 806
82, 1200, 0.44, 0.409166666667, 491, 361, 839
82, 1250, 0.42, 0.4096, 512, 375, 875
82, 1300, 0.34, 0.406923076923, 529, 389, 911
82, 1350, 0.48, 0.40962962963, 553, 401, 949
82, 1400, 0.34, 0.407142857143, 570, 407, 993
82, 1450, 0.36, 0.405517241379, 588, 418, 1032
82, 1500, 0.5, 0.408666666667, 613, 424, 1076
82, 1550, 0.54, 0.412903225806, 640, 428, 1122
82, 1600, 0.28, 0.40875, 654, 436, 1164
82, 1650, 0.42, 0.409090909091, 675, 442, 1208
82, 1700, 0.36, 0.407647058824, 693, 446, 1254
82, 1750, 0.52, 0.410857142857, 719, 453, 1297
82, 1800, 0.42, 0.411111111111, 740, 459, 1341
82, 1850, 0.44, 0.411891891892, 762, 464, 1386
82, 1900, 0.38, 0.411052631579, 781, 467, 1433
82, 1950, 0.4, 0.410769230769, 801, 470, 1480
82, 2000, 0.3, 0.408, 816, 473, 1527
83, 50, 0.4, 0.4, 20, 28, 22
83, 100, 0.44, 0.42, 42, 50, 50
83, 150, 0.34, 0.393333333333, 59, 70, 80
83, 200, 0.36, 0.385, 77, 90, 110
83, 250, 0.48, 0.404, 101, 115, 135
83, 300, 0.42, 0.406666666667, 122, 140, 160
83, 350, 0.42, 0.408571428571, 143, 160, 190
83, 400, 0.44, 0.4125, 165, 191, 209
83, 450, 0.46, 0.417777777778, 188, 212, 238
83, 500, 0.34, 0.41, 205, 230, 270
83, 550, 0.46, 0.414545454545, 228, 241, 309
83, 600, 0.42, 0.415, 249, 248, 352
83, 650, 0.48, 0.42, 273, 253, 397
83, 700, 0.38, 0.417142857143, 292, 259, 441
83, 750, 0.3, 0.409333333333, 307, 263, 487
83, 800, 0.48, 0.41375, 331, 265, 535
83, 850, 0.44, 0.415294117647, 353, 268, 582
83, 900, 0.4, 0.414444444444, 373, 270, 630
83, 950, 0.38, 0.412631578947, 392, 271, 679
83, 1000, 0.4, 0.412, 412, 273, 727
83, 1050, 0.5, 0.41619047619, 437, 273, 777
83, 1100, 0.46, 0.418181818182, 460, 277, 823
83, 1150, 0.44, 0.419130434783, 482, 277, 873
83, 1200, 0.5, 0.4225, 507, 280, 920
83, 1250, 0.42, 0.4224, 528, 283, 967
83, 1300, 0.46, 0.423846153846, 551, 286, 1014
83, 1350, 0.46, 0.425185185185, 574, 291, 1059
83, 1400, 0.42, 0.425, 595, 294, 1106
83, 1450, 0.5, 0.427586206897, 620, 300, 1150
83, 1500, 0.28, 0.422666666667, 634, 306, 1194
83, 1550, 0.32, 0.41935483871, 650, 309, 1241
83, 1600, 0.46, 0.420625, 673, 313, 1287
83, 1650, 0.38, 0.419393939394, 692, 318, 1332
83, 1700, 0.6, 0.424705882353, 722, 330, 1370
83, 1750, 0.42, 0.424571428571, 743, 343, 1407
83, 1800, 0.36, 0.422777777778, 761, 349, 1451
83, 1850, 0.3, 0.419459459459, 776, 355, 1495
83, 1900, 0.34, 0.417368421053, 793, 362, 1538
83, 1950, 0.46, 0.418461538462, 816, 373, 1577
83, 2000, 0.34, 0.4165, 833, 377, 1623
84, 50, 0.38, 0.38, 19, 23, 27
84, 100, 0.34, 0.36, 36, 44, 56
84, 150, 0.26, 0.326666666667, 49, 68, 82
84, 200, 0.4, 0.345, 69, 95, 105
84, 250, 0.36, 0.348, 87, 120, 130
84, 300, 0.36, 0.35, 105, 147, 153
84, 350, 0.3, 0.342857142857, 120, 177, 173
84, 400, 0.36, 0.345, 138, 205, 195
84, 450, 0.46, 0.357777777778, 161, 240, 210
84, 500, 0.3, 0.352, 176, 281, 219
84, 550, 0.32, 0.349090909091, 192, 323, 227
84, 600, 0.36, 0.35, 210, 365, 235
84, 650, 0.34, 0.349230769231, 227, 410, 240
84, 700, 0.26, 0.342857142857, 240, 453, 247
84, 750, 0.48, 0.352, 264, 499, 251
84, 800, 0.28, 0.3475, 278, 543, 257
84, 850, 0.38, 0.349411764706, 297, 586, 264
84, 900, 0.34, 0.348888888889, 314, 631, 269
84, 950, 0.52, 0.357894736842, 340, 676, 274
84, 1000, 0.32, 0.356, 356, 716, 284
84, 1050, 0.4, 0.358095238095, 376, 758, 292
84, 1100, 0.26, 0.353636363636, 389, 804, 296
84, 1150, 0.32, 0.352173913043, 405, 846, 304
84, 1200, 0.34, 0.351666666667, 422, 891, 309
84, 1250, 0.38, 0.3528, 441, 931, 319
84, 1300, 0.5, 0.358461538462, 466, 968, 332
84, 1350, 0.46, 0.362222222222, 489, 1002, 348
84, 1400, 0.4, 0.363571428571, 509, 1031, 369
84, 1450, 0.42, 0.365517241379, 530, 1056, 394
84, 1500, 0.44, 0.368, 552, 1092, 408
84, 1550, 0.48, 0.371612903226, 576, 1119, 431
84, 1600, 0.32, 0.37, 592, 1142, 458
84, 1650, 0.46, 0.372727272727, 615, 1169, 481
84, 1700, 0.38, 0.372941176471, 634, 1194, 506
84, 1750, 0.48, 0.376, 658, 1229, 521
84, 1800, 0.48, 0.378888888889, 682, 1265, 535
84, 1850, 0.24, 0.375135135135, 694, 1300, 550
84, 1900, 0.5, 0.378421052632, 719, 1327, 573
84, 1950, 0.5, 0.381538461538, 744, 1346, 604
84, 2000, 0.42, 0.3825, 765, 1364, 636
85, 50, 0.28, 0.28, 14, 23, 27
85, 100, 0.3, 0.29, 29, 46, 54
85, 150, 0.4, 0.326666666667, 49, 69, 81
85, 200, 0.44, 0.355, 71, 97, 103
85, 250, 0.46, 0.376, 94, 123, 127
85, 300, 0.4, 0.38, 114, 148, 152
85, 350, 0.5, 0.397142857143, 139, 174, 176
85, 400, 0.26, 0.38, 152, 195, 205
85, 450, 0.38, 0.38, 171, 225, 225
85, 500, 0.36, 0.378, 189, 261, 239
85, 550, 0.4, 0.38, 209, 290, 260
85, 600, 0.36, 0.378333333333, 227, 315, 285
85, 650, 0.3, 0.372307692308, 242, 353, 297
85, 700, 0.3, 0.367142857143, 257, 390, 310
85, 750, 0.38, 0.368, 276, 428, 322
85, 800, 0.54, 0.37875, 303, 475, 325
85, 850, 0.46, 0.383529411765, 326, 516, 334
85, 900, 0.36, 0.382222222222, 344, 561, 339
85, 950, 0.42, 0.384210526316, 365, 605, 345
85, 1000, 0.42, 0.386, 386, 647, 353
85, 1050, 0.38, 0.385714285714, 405, 694, 356
85, 1100, 0.34, 0.383636363636, 422, 737, 363
85, 1150, 0.42, 0.385217391304, 443, 780, 370
85, 1200, 0.28, 0.380833333333, 457, 825, 375
85, 1250, 0.54, 0.3872, 484, 870, 380
85, 1300, 0.4, 0.387692307692, 504, 916, 384
85, 1350, 0.28, 0.383703703704, 518, 961, 389
85, 1400, 0.38, 0.383571428571, 537, 1009, 391
85, 1450, 0.36, 0.38275862069, 555, 1052, 398
85, 1500, 0.46, 0.385333333333, 578, 1098, 402
85, 1550, 0.36, 0.384516129032, 596, 1144, 406
85, 1600, 0.4, 0.385, 616, 1191, 409
85, 1650, 0.46, 0.387272727273, 639, 1233, 417
85, 1700, 0.36, 0.386470588235, 657, 1276, 424
85, 1750, 0.34, 0.385142857143, 674, 1312, 438
85, 1800, 0.36, 0.384444444444, 692, 1357, 443
85, 1850, 0.38, 0.384324324324, 711, 1402, 448
85, 1900, 0.36, 0.383684210526, 729, 1444, 456
85, 1950, 0.4, 0.384102564103, 749, 1487, 463
85, 2000, 0.36, 0.3835, 767, 1530, 470
86, 50, 0.3, 0.3, 15, 26, 24
86, 100, 0.34, 0.32, 32, 51, 49
86, 150, 0.26, 0.3, 45, 80, 70
86, 200, 0.32, 0.305, 61, 104, 96
86, 250, 0.4, 0.324, 81, 127, 123
86, 300, 0.52, 0.356666666667, 107, 154, 146
86, 350, 0.3, 0.348571428571, 122, 180, 170
86, 400, 0.4, 0.355, 142, 202, 198
86, 450, 0.4, 0.36, 162, 229, 221
86, 500, 0.36, 0.36, 180, 260, 240
86, 550, 0.4, 0.363636363636, 200, 280, 270
86, 600, 0.46, 0.371666666667, 223, 291, 309
86, 650, 0.38, 0.372307692308, 242, 299, 351
86, 700, 0.32, 0.368571428571, 258, 304, 396
86, 750, 0.42, 0.372, 279, 310, 440
86, 800, 0.4, 0.37375, 299, 316, 484
86, 850, 0.38, 0.374117647059, 318, 325, 525
86, 900, 0.3, 0.37, 333, 331, 569
86, 950, 0.38, 0.370526315789, 352, 339, 611
86, 1000, 0.44, 0.374, 374, 344, 656
86, 1050, 0.32, 0.371428571429, 390, 347, 703
86, 1100, 0.26, 0.366363636364, 403, 354, 746
86, 1150, 0.3, 0.36347826087, 418, 366, 784
86, 1200, 0.38, 0.364166666667, 437, 377, 823
86, 1250, 0.34, 0.3632, 454, 390, 860
86, 1300, 0.4, 0.364615384615, 474, 397, 903
86, 1350, 0.44, 0.367407407407, 496, 406, 944
86, 1400, 0.44, 0.37, 518, 419, 981
86, 1450, 0.42, 0.371724137931, 539, 428, 1022
86, 1500, 0.36, 0.371333333333, 557, 439, 1061
86, 1550, 0.38, 0.371612903226, 576, 445, 1105
86, 1600, 0.46, 0.374375, 599, 449, 1151
86, 1650, 0.38, 0.374545454545, 618, 454, 1196
86, 1700, 0.46, 0.377058823529, 641, 460, 1240
86, 1750, 0.36, 0.376571428571, 659, 464, 1286
86, 1800, 0.34, 0.375555555556, 676, 468, 1332
86, 1850, 0.44, 0.377297297297, 698, 468, 1382
86, 1900, 0.44, 0.378947368421, 720, 470, 1430
86, 1950, 0.38, 0.378974358974, 739, 473, 1477
86, 2000, 0.32, 0.3775, 755, 481, 1519
87, 50, 0.34, 0.34, 17, 21, 29
87, 100, 0.26, 0.3, 30, 40, 60
87, 150, 0.34, 0.313333333333, 47, 64, 86
87, 200, 0.42, 0.34, 68, 89, 111
87, 250, 0.34, 0.34, 85, 118, 132
87, 300, 0.42, 0.353333333333, 106, 137, 163
87, 350, 0.38, 0.357142857143, 125, 163, 187
87, 400, 0.42, 0.365, 146, 191, 209
87, 450, 0.34, 0.362222222222, 163, 207, 243
87, 500, 0.42, 0.368, 184, 216, 284
87, 550, 0.36, 0.367272727273, 202, 218, 332
87, 600, 0.4, 0.37, 222, 219, 381
87, 650, 0.42, 0.373846153846, 243, 223, 427
87, 700, 0.5, 0.382857142857, 268, 224, 476
87, 750, 0.36, 0.381333333333, 286, 227, 523
87, 800, 0.32, 0.3775, 302, 228, 572
87, 850, 0.44, 0.381176470588, 324, 228, 622
87, 900, 0.32, 0.377777777778, 340, 229, 671
87, 950, 0.42, 0.38, 361, 232, 718
87, 1000, 0.4, 0.381, 381, 234, 766
87, 1050, 0.32, 0.378095238095, 397, 237, 813
87, 1100, 0.34, 0.376363636364, 414, 238, 862
87, 1150, 0.36, 0.375652173913, 432, 240, 910
87, 1200, 0.44, 0.378333333333, 454, 242, 958
87, 1250, 0.5, 0.3832, 479, 246, 1004
87, 1300, 0.42, 0.384615384615, 500, 250, 1050
87, 1350, 0.46, 0.387407407407, 523, 252, 1098
87, 1400, 0.4, 0.387857142857, 543, 254, 1146
87, 1450, 0.26, 0.383448275862, 556, 256, 1194
87, 1500, 0.48, 0.386666666667, 580, 257, 1243
87, 1550, 0.4, 0.387096774194, 600, 259, 1291
87, 1600, 0.38, 0.386875, 619, 264, 1336
87, 1650, 0.14, 0.379393939394, 626, 270, 1380
87, 1700, 0.3, 0.377058823529, 641, 274, 1426
87, 1750, 0.54, 0.381714285714, 668, 279, 1471
87, 1800, 0.48, 0.384444444444, 692, 282, 1518
87, 1850, 0.44, 0.385945945946, 714, 287, 1563
87, 1900, 0.42, 0.386842105263, 735, 290, 1610
87, 1950, 0.42, 0.387692307692, 756, 291, 1659
87, 2000, 0.4, 0.388, 776, 292, 1708
88, 50, 0.38, 0.38, 19, 21, 29
88, 100, 0.44, 0.41, 41, 45, 55
88, 150, 0.3, 0.373333333333, 56, 67, 83
88, 200, 0.44, 0.39, 78, 95, 105
88, 250, 0.44, 0.4, 100, 117, 133
88, 300, 0.42, 0.403333333333, 121, 146, 154
88, 350, 0.42, 0.405714285714, 142, 170, 180
88, 400, 0.18, 0.3775, 151, 191, 209
88, 450, 0.4, 0.38, 171, 210, 240
88, 500, 0.46, 0.388, 194, 222, 278
88, 550, 0.36, 0.385454545455, 212, 233, 317
88, 600, 0.36, 0.383333333333, 230, 241, 359
88, 650, 0.36, 0.381538461538, 248, 252, 398
88, 700, 0.26, 0.372857142857, 261, 259, 441
88, 750, 0.48, 0.38, 285, 281, 469
88, 800, 0.42, 0.3825, 306, 301, 499
88, 850, 0.44, 0.385882352941, 328, 319, 531
88, 900, 0.44, 0.388888888889, 350, 337, 563
88, 950, 0.32, 0.385263157895, 366, 353, 597
88, 1000, 0.34, 0.383, 383, 364, 636
88, 1050, 0.3, 0.379047619048, 398, 373, 677
88, 1100, 0.36, 0.378181818182, 416, 383, 717
88, 1150, 0.34, 0.37652173913, 433, 393, 757
88, 1200, 0.38, 0.376666666667, 452, 416, 784
88, 1250, 0.38, 0.3768, 471, 438, 812
88, 1300, 0.36, 0.376153846154, 489, 452, 848
88, 1350, 0.22, 0.37037037037, 500, 470, 880
88, 1400, 0.34, 0.369285714286, 517, 497, 903
88, 1450, 0.32, 0.367586206897, 533, 515, 935
88, 1500, 0.46, 0.370666666667, 556, 529, 971
88, 1550, 0.36, 0.370322580645, 574, 549, 1001
88, 1600, 0.34, 0.369375, 591, 568, 1032
88, 1650, 0.34, 0.368484848485, 608, 589, 1061
88, 1700, 0.4, 0.369411764706, 628, 607, 1093
88, 1750, 0.52, 0.373714285714, 654, 616, 1134
88, 1800, 0.4, 0.374444444444, 674, 633, 1167
88, 1850, 0.38, 0.374594594595, 693, 649, 1201
88, 1900, 0.52, 0.378421052632, 719, 663, 1237
88, 1950, 0.44, 0.38, 741, 684, 1266
88, 2000, 0.26, 0.377, 754, 705, 1295
89, 50, 0.44, 0.44, 22, 20, 30
89, 100, 0.28, 0.36, 36, 40, 60
89, 150, 0.38, 0.366666666667, 55, 63, 87
89, 200, 0.54, 0.41, 82, 90, 110
89, 250, 0.4, 0.408, 102, 112, 138
89, 300, 0.34, 0.396666666667, 119, 140, 160
89, 350, 0.44, 0.402857142857, 141, 167, 183
89, 400, 0.3, 0.39, 156, 186, 214
89, 450, 0.28, 0.377777777778, 170, 213, 237
89, 500, 0.48, 0.388, 194, 224, 276
89, 550, 0.42, 0.390909090909, 215, 228, 322
89, 600, 0.42, 0.393333333333, 236, 239, 361
89, 650, 0.32, 0.387692307692, 252, 244, 406
89, 700, 0.32, 0.382857142857, 268, 256, 444
89, 750, 0.4, 0.384, 288, 267, 483
89, 800, 0.32, 0.38, 304, 279, 521
89, 850, 0.26, 0.372941176471, 317, 304, 546
89, 900, 0.42, 0.375555555556, 338, 334, 566
89, 950, 0.28, 0.370526315789, 352, 358, 592
89, 1000, 0.42, 0.373, 373, 371, 629
89, 1050, 0.46, 0.377142857143, 396, 386, 664
89, 1100, 0.32, 0.374545454545, 412, 405, 695
89, 1150, 0.46, 0.378260869565, 435, 415, 735
89, 1200, 0.52, 0.384166666667, 461, 430, 770
89, 1250, 0.42, 0.3856, 482, 440, 810
89, 1300, 0.44, 0.387692307692, 504, 448, 852
89, 1350, 0.34, 0.385925925926, 521, 456, 894
89, 1400, 0.48, 0.389285714286, 545, 464, 936
89, 1450, 0.3, 0.386206896552, 560, 477, 973
89, 1500, 0.32, 0.384, 576, 491, 1009
89, 1550, 0.36, 0.383225806452, 594, 501, 1049
89, 1600, 0.4, 0.38375, 614, 518, 1082
89, 1650, 0.34, 0.382424242424, 631, 525, 1125
89, 1700, 0.54, 0.387058823529, 658, 537, 1163
89, 1750, 0.36, 0.386285714286, 676, 546, 1204
89, 1800, 0.54, 0.390555555556, 703, 558, 1242
89, 1850, 0.42, 0.391351351351, 724, 565, 1285
89, 1900, 0.44, 0.392631578947, 746, 571, 1329
89, 1950, 0.4, 0.392820512821, 766, 575, 1375
89, 2000, 0.18, 0.3875, 775, 580, 1420
90, 50, 0.46, 0.46, 23, 25, 25
90, 100, 0.42, 0.44, 44, 55, 45
90, 150, 0.38, 0.42, 63, 89, 61
90, 200, 0.4, 0.415, 83, 112, 88
90, 250, 0.36, 0.404, 101, 139, 111
90, 300, 0.28, 0.383333333333, 115, 163, 137
90, 350, 0.42, 0.388571428571, 136, 186, 164
90, 400, 0.26, 0.3725, 149, 206, 194
90, 450, 0.46, 0.382222222222, 172, 219, 231
90, 500, 0.42, 0.386, 193, 227, 273
90, 550, 0.46, 0.392727272727, 216, 230, 320
90, 600, 0.52, 0.403333333333, 242, 237, 363
90, 650, 0.4, 0.403076923077, 262, 243, 407
90, 700, 0.46, 0.407142857143, 285, 248, 452
90, 750, 0.34, 0.402666666667, 302, 253, 497
90, 800, 0.22, 0.39125, 313, 258, 542
90, 850, 0.3, 0.385882352941, 328, 269, 581
90, 900, 0.44, 0.388888888889, 350, 282, 618
90, 950, 0.52, 0.395789473684, 376, 295, 655
90, 1000, 0.44, 0.398, 398, 307, 693
90, 1050, 0.34, 0.395238095238, 415, 312, 738
90, 1100, 0.5, 0.4, 440, 317, 783
90, 1150, 0.38, 0.399130434783, 459, 325, 825
90, 1200, 0.46, 0.401666666667, 482, 329, 871
90, 1250, 0.48, 0.4048, 506, 333, 917
90, 1300, 0.38, 0.403846153846, 525, 338, 962
90, 1350, 0.44, 0.405185185185, 547, 340, 1010
90, 1400, 0.46, 0.407142857143, 570, 343, 1057
90, 1450, 0.36, 0.405517241379, 588, 345, 1105
90, 1500, 0.48, 0.408, 612, 349, 1151
90, 1550, 0.3, 0.404516129032, 627, 352, 1198
90, 1600, 0.58, 0.41, 656, 356, 1244
90, 1650, 0.38, 0.409090909091, 675, 359, 1291
90, 1700, 0.32, 0.406470588235, 691, 361, 1339
90, 1750, 0.36, 0.405142857143, 709, 366, 1384
90, 1800, 0.42, 0.405555555556, 730, 370, 1430
90, 1850, 0.42, 0.405945945946, 751, 373, 1477
90, 1900, 0.32, 0.403684210526, 767, 377, 1523
90, 1950, 0.46, 0.405128205128, 790, 383, 1567
90, 2000, 0.42, 0.4055, 811, 393, 1607
91, 50, 0.4, 0.4, 20, 27, 23
91, 100, 0.42, 0.41, 41, 52, 48
91, 150, 0.38, 0.4, 60, 81, 69
91, 200, 0.38, 0.395, 79, 109, 91
91, 250, 0.44, 0.404, 101, 133, 117
91, 300, 0.46, 0.413333333333, 124, 159, 141
91, 350, 0.36, 0.405714285714, 142, 183, 167
91, 400, 0.42, 0.4075, 163, 199, 201
91, 450, 0.38, 0.404444444444, 182, 215, 235
91, 500, 0.36, 0.4, 200, 231, 269
91, 550, 0.28, 0.389090909091, 214, 241, 309
91, 600, 0.44, 0.393333333333, 236, 255, 345
91, 650, 0.38, 0.392307692308, 255, 265, 385
91, 700, 0.36, 0.39, 273, 270, 430
91, 750, 0.34, 0.386666666667, 290, 275, 475
91, 800, 0.44, 0.39, 312, 280, 520
91, 850, 0.42, 0.391764705882, 333, 287, 563
91, 900, 0.46, 0.395555555556, 356, 291, 609
91, 950, 0.5, 0.401052631579, 381, 297, 653
91, 1000, 0.4, 0.401, 401, 301, 699
91, 1050, 0.44, 0.402857142857, 423, 304, 746
91, 1100, 0.52, 0.408181818182, 449, 305, 795
91, 1150, 0.48, 0.411304347826, 473, 307, 843
91, 1200, 0.54, 0.416666666667, 500, 308, 892
91, 1250, 0.38, 0.4152, 519, 308, 942
91, 1300, 0.46, 0.416923076923, 542, 308, 992
91, 1350, 0.36, 0.414814814815, 560, 308, 1042
91, 1400, 0.42, 0.415, 581, 309, 1091
91, 1450, 0.38, 0.413793103448, 600, 309, 1141
91, 1500, 0.26, 0.408666666667, 613, 309, 1191
91, 1550, 0.42, 0.409032258065, 634, 310, 1240
91, 1600, 0.46, 0.410625, 657, 311, 1289
91, 1650, 0.46, 0.412121212121, 680, 311, 1339
91, 1700, 0.28, 0.408235294118, 694, 312, 1388
91, 1750, 0.42, 0.408571428571, 715, 312, 1438
91, 1800, 0.3, 0.405555555556, 730, 314, 1486
91, 1850, 0.4, 0.405405405405, 750, 315, 1535
91, 1900, 0.24, 0.401052631579, 762, 316, 1584
91, 1950, 0.34, 0.399487179487, 779, 317, 1633
91, 2000, 0.36, 0.3985, 797, 319, 1681
92, 50, 0.34, 0.34, 17, 25, 25
92, 100, 0.24, 0.29, 29, 53, 47
92, 150, 0.44, 0.34, 51, 76, 74
92, 200, 0.44, 0.365, 73, 98, 102
92, 250, 0.46, 0.384, 96, 125, 125
92, 300, 0.5, 0.403333333333, 121, 151, 149
92, 350, 0.4, 0.402857142857, 141, 173, 177
92, 400, 0.4, 0.4025, 161, 196, 204
92, 450, 0.36, 0.397777777778, 179, 228, 222
92, 500, 0.48, 0.406, 203, 254, 246
92, 550, 0.4, 0.405454545455, 223, 275, 275
92, 600, 0.48, 0.411666666667, 247, 289, 311
92, 650, 0.42, 0.412307692308, 268, 305, 345
92, 700, 0.48, 0.417142857143, 292, 326, 374
92, 750, 0.4, 0.416, 312, 345, 405
92, 800, 0.5, 0.42125, 337, 371, 429
92, 850, 0.38, 0.418823529412, 356, 404, 446
92, 900, 0.52, 0.424444444444, 382, 441, 459
92, 950, 0.32, 0.418947368421, 398, 473, 477
92, 1000, 0.38, 0.417, 417, 499, 501
92, 1050, 0.24, 0.408571428571, 429, 528, 522
92, 1100, 0.32, 0.404545454545, 445, 562, 538
92, 1150, 0.36, 0.402608695652, 463, 593, 557
92, 1200, 0.36, 0.400833333333, 481, 615, 585
92, 1250, 0.3, 0.3968, 496, 636, 614
92, 1300, 0.3, 0.393076923077, 511, 661, 639
92, 1350, 0.38, 0.392592592593, 530, 691, 659
92, 1400, 0.52, 0.397142857143, 556, 717, 683
92, 1450, 0.38, 0.396551724138, 575, 744, 706
92, 1500, 0.3, 0.393333333333, 590, 772, 728
92, 1550, 0.32, 0.390967741935, 606, 795, 755
92, 1600, 0.32, 0.38875, 622, 828, 772
92, 1650, 0.34, 0.387272727273, 639, 849, 801
92, 1700, 0.4, 0.387647058824, 659, 877, 823
92, 1750, 0.42, 0.388571428571, 680, 904, 846
92, 1800, 0.4, 0.388888888889, 700, 929, 871
92, 1850, 0.4, 0.389189189189, 720, 951, 899
92, 1900, 0.24, 0.385263157895, 732, 968, 932
92, 1950, 0.5, 0.388205128205, 757, 982, 968
92, 2000, 0.4, 0.3885, 777, 996, 1004
93, 50, 0.34, 0.34, 17, 24, 26
93, 100, 0.46, 0.4, 40, 53, 47
93, 150, 0.38, 0.393333333333, 59, 82, 68
93, 200, 0.36, 0.385, 77, 104, 96
93, 250, 0.44, 0.396, 99, 127, 123
93, 300, 0.52, 0.416666666667, 125, 149, 151
93, 350, 0.42, 0.417142857143, 146, 174, 176
93, 400, 0.42, 0.4175, 167, 195, 205
93, 450, 0.4, 0.415555555556, 187, 214, 236
93, 500, 0.36, 0.41, 205, 226, 274
93, 550, 0.48, 0.416363636364, 229, 238, 312
93, 600, 0.3, 0.406666666667, 244, 251, 349
93, 650, 0.28, 0.396923076923, 258, 264, 386
93, 700, 0.26, 0.387142857143, 271, 271, 429
93, 750, 0.34, 0.384, 288, 288, 462
93, 800, 0.26, 0.37625, 301, 311, 489
93, 850, 0.36, 0.375294117647, 319, 326, 524
93, 900, 0.36, 0.374444444444, 337, 341, 559
93, 950, 0.26, 0.368421052632, 350, 352, 598
93, 1000, 0.5, 0.375, 375, 361, 639
93, 1050, 0.5, 0.380952380952, 400, 374, 676
93, 1100, 0.44, 0.383636363636, 422, 381, 719
93, 1150, 0.42, 0.385217391304, 443, 395, 755
93, 1200, 0.34, 0.383333333333, 460, 410, 790
93, 1250, 0.32, 0.3808, 476, 422, 828
93, 1300, 0.44, 0.383076923077, 498, 439, 861
93, 1350, 0.36, 0.382222222222, 516, 456, 894
93, 1400, 0.42, 0.383571428571, 537, 480, 920
93, 1450, 0.42, 0.384827586207, 558, 510, 940
93, 1500, 0.46, 0.387333333333, 581, 537, 963
93, 1550, 0.34, 0.385806451613, 598, 560, 990
93, 1600, 0.44, 0.3875, 620, 574, 1026
93, 1650, 0.36, 0.386666666667, 638, 587, 1063
93, 1700, 0.42, 0.387647058824, 659, 603, 1097
93, 1750, 0.28, 0.384571428571, 673, 621, 1129
93, 1800, 0.36, 0.383888888889, 691, 634, 1166
93, 1850, 0.44, 0.385405405405, 713, 653, 1197
93, 1900, 0.36, 0.384736842105, 731, 670, 1230
93, 1950, 0.38, 0.384615384615, 750, 682, 1268
93, 2000, 0.44, 0.386, 772, 698, 1302
94, 50, 0.46, 0.46, 23, 21, 29
94, 100, 0.32, 0.39, 39, 45, 55
94, 150, 0.4, 0.393333333333, 59, 70, 80
94, 200, 0.54, 0.43, 86, 97, 103
94, 250, 0.34, 0.412, 103, 121, 129
94, 300, 0.44, 0.416666666667, 125, 142, 158
94, 350, 0.4, 0.414285714286, 145, 167, 183
94, 400, 0.26, 0.395, 158, 192, 208
94, 450, 0.38, 0.393333333333, 177, 203, 247
94, 500, 0.36, 0.39, 195, 213, 287
94, 550, 0.38, 0.389090909091, 214, 217, 333
94, 600, 0.36, 0.386666666667, 232, 223, 377
94, 650, 0.46, 0.392307692308, 255, 229, 421
94, 700, 0.32, 0.387142857143, 271, 238, 462
94, 750, 0.54, 0.397333333333, 298, 245, 505
94, 800, 0.44, 0.4, 320, 252, 548
94, 850, 0.32, 0.395294117647, 336, 256, 594
94, 900, 0.48, 0.4, 360, 269, 631
94, 950, 0.38, 0.398947368421, 379, 278, 672
94, 1000, 0.42, 0.4, 400, 294, 706
94, 1050, 0.32, 0.39619047619, 416, 306, 744
94, 1100, 0.38, 0.395454545455, 435, 325, 775
94, 1150, 0.34, 0.393043478261, 452, 349, 801
94, 1200, 0.44, 0.395, 474, 364, 836
94, 1250, 0.52, 0.4, 500, 381, 869
94, 1300, 0.36, 0.398461538462, 518, 392, 908
94, 1350, 0.36, 0.397037037037, 536, 403, 947
94, 1400, 0.4, 0.397142857143, 556, 417, 983
94, 1450, 0.52, 0.401379310345, 582, 426, 1024
94, 1500, 0.36, 0.4, 600, 443, 1057
94, 1550, 0.48, 0.402580645161, 624, 456, 1094
94, 1600, 0.36, 0.40125, 642, 468, 1132
94, 1650, 0.44, 0.402424242424, 664, 479, 1171
94, 1700, 0.5, 0.405294117647, 689, 486, 1214
94, 1750, 0.28, 0.401714285714, 703, 493, 1257
94, 1800, 0.5, 0.404444444444, 728, 497, 1303
94, 1850, 0.5, 0.407027027027, 753, 501, 1349
94, 1900, 0.4, 0.406842105263, 773, 506, 1394
94, 1950, 0.52, 0.409743589744, 799, 506, 1444
94, 2000, 0.38, 0.409, 818, 507, 1493
95, 50, 0.48, 0.48, 24, 26, 24
95, 100, 0.36, 0.42, 42, 54, 46
95, 150, 0.46, 0.433333333333, 65, 83, 67
95, 200, 0.32, 0.405, 81, 105, 95
95, 250, 0.38, 0.4, 100, 125, 125
95, 300, 0.44, 0.406666666667, 122, 146, 154
95, 350, 0.26, 0.385714285714, 135, 161, 189
95, 400, 0.34, 0.38, 152, 188, 212
95, 450, 0.5, 0.393333333333, 177, 204, 246
95, 500, 0.42, 0.396, 198, 231, 269
95, 550, 0.4, 0.396363636364, 218, 259, 291
95, 600, 0.24, 0.383333333333, 230, 290, 310
95, 650, 0.42, 0.386153846154, 251, 317, 333
95, 700, 0.46, 0.391428571429, 274, 334, 366
95, 750, 0.28, 0.384, 288, 359, 391
95, 800, 0.36, 0.3825, 306, 386, 414
95, 850, 0.38, 0.382352941176, 325, 405, 445
95, 900, 0.32, 0.378888888889, 341, 419, 481
95, 950, 0.44, 0.382105263158, 363, 429, 521
95, 1000, 0.44, 0.385, 385, 440, 560
95, 1050, 0.5, 0.390476190476, 410, 458, 592
95, 1100, 0.36, 0.389090909091, 428, 465, 635
95, 1150, 0.52, 0.394782608696, 454, 469, 681
95, 1200, 0.42, 0.395833333333, 475, 479, 721
95, 1250, 0.34, 0.3936, 492, 480, 770
95, 1300, 0.42, 0.394615384615, 513, 483, 817
95, 1350, 0.36, 0.393333333333, 531, 486, 864
95, 1400, 0.36, 0.392142857143, 549, 496, 904
95, 1450, 0.32, 0.389655172414, 565, 505, 945
95, 1500, 0.36, 0.388666666667, 583, 515, 985
95, 1550, 0.3, 0.385806451613, 598, 524, 1026
95, 1600, 0.4, 0.38625, 618, 531, 1069
95, 1650, 0.32, 0.384242424242, 634, 537, 1113
95, 1700, 0.34, 0.382941176471, 651, 552, 1148
95, 1750, 0.4, 0.383428571429, 671, 566, 1184
95, 1800, 0.4, 0.383888888889, 691, 573, 1227
95, 1850, 0.5, 0.387027027027, 716, 589, 1261
95, 1900, 0.52, 0.390526315789, 742, 601, 1299
95, 1950, 0.44, 0.391794871795, 764, 608, 1342
95, 2000, 0.26, 0.3885, 777, 619, 1381
96, 50, 0.36, 0.36, 18, 23, 27
96, 100, 0.4, 0.38, 38, 41, 59
96, 150, 0.36, 0.373333333333, 56, 64, 86
96, 200, 0.42, 0.385, 77, 88, 112
96, 250, 0.32, 0.372, 93, 118, 132
96, 300, 0.4, 0.376666666667, 113, 142, 158
96, 350, 0.34, 0.371428571429, 130, 172, 178
96, 400, 0.42, 0.3775, 151, 195, 205
96, 450, 0.42, 0.382222222222, 172, 208, 242
96, 500, 0.4, 0.384, 192, 219, 281
96, 550, 0.46, 0.390909090909, 215, 230, 320
96, 600, 0.2, 0.375, 225, 239, 361
96, 650, 0.42, 0.378461538462, 246, 246, 404
96, 700, 0.44, 0.382857142857, 268, 253, 447
96, 750, 0.44, 0.386666666667, 290, 255, 495
96, 800, 0.34, 0.38375, 307, 257, 543
96, 850, 0.42, 0.385882352941, 328, 261, 589
96, 900, 0.3, 0.381111111111, 343, 264, 636
96, 950, 0.42, 0.383157894737, 364, 267, 683
96, 1000, 0.4, 0.384, 384, 270, 730
96, 1050, 0.34, 0.381904761905, 401, 271, 779
96, 1100, 0.3, 0.378181818182, 416, 272, 828
96, 1150, 0.4, 0.379130434783, 436, 274, 876
96, 1200, 0.44, 0.381666666667, 458, 281, 919
96, 1250, 0.4, 0.3824, 478, 283, 967
96, 1300, 0.38, 0.382307692308, 497, 284, 1016
96, 1350, 0.48, 0.385925925926, 521, 285, 1065
96, 1400, 0.46, 0.388571428571, 544, 288, 1112
96, 1450, 0.38, 0.388275862069, 563, 288, 1162
96, 1500, 0.52, 0.392666666667, 589, 288, 1212
96, 1550, 0.46, 0.394838709677, 612, 289, 1261
96, 1600, 0.62, 0.401875, 643, 292, 1308
96, 1650, 0.42, 0.402424242424, 664, 293, 1357
96, 1700, 0.36, 0.401176470588, 682, 294, 1406
96, 1750, 0.42, 0.401714285714, 703, 295, 1455
96, 1800, 0.46, 0.403333333333, 726, 296, 1504
96, 1850, 0.4, 0.403243243243, 746, 296, 1554
96, 1900, 0.4, 0.403157894737, 766, 297, 1603
96, 1950, 0.36, 0.402051282051, 784, 299, 1651
96, 2000, 0.38, 0.4015, 803, 300, 1700
97, 50, 0.4, 0.4, 20, 29, 21
97, 100, 0.32, 0.36, 36, 49, 51
97, 150, 0.42, 0.38, 57, 76, 74
97, 200, 0.28, 0.355, 71, 106, 94
97, 250, 0.44, 0.372, 93, 130, 120
97, 300, 0.36, 0.37, 111, 159, 141
97, 350, 0.34, 0.365714285714, 128, 177, 173
97, 400, 0.38, 0.3675, 147, 202, 198
97, 450, 0.42, 0.373333333333, 168, 219, 231
97, 500, 0.38, 0.374, 187, 224, 276
97, 550, 0.44, 0.38, 209, 224, 326
97, 600, 0.52, 0.391666666667, 235, 225, 375
97, 650, 0.34, 0.387692307692, 252, 226, 424
97, 700, 0.52, 0.397142857143, 278, 227, 473
97, 750, 0.38, 0.396, 297, 228, 522
97, 800, 0.38, 0.395, 316, 230, 570
97, 850, 0.4, 0.395294117647, 336, 230, 620
97, 900, 0.44, 0.397777777778, 358, 230, 670
97, 950, 0.52, 0.404210526316, 384, 230, 720
97, 1000, 0.3, 0.399, 399, 230, 770
97, 1050, 0.38, 0.398095238095, 418, 231, 819
97, 1100, 0.44, 0.4, 440, 231, 869
97, 1150, 0.26, 0.393913043478, 453, 231, 919
97, 1200, 0.38, 0.393333333333, 472, 232, 968
97, 1250, 0.42, 0.3944, 493, 232, 1018
97, 1300, 0.46, 0.396923076923, 516, 232, 1068
97, 1350, 0.32, 0.394074074074, 532, 233, 1117
97, 1400, 0.44, 0.395714285714, 554, 233, 1167
97, 1450, 0.46, 0.397931034483, 577, 234, 1216
97, 1500, 0.46, 0.4, 600, 234, 1266
97, 1550, 0.42, 0.40064516129, 621, 234, 1316
97, 1600, 0.38, 0.4, 640, 234, 1366
97, 1650, 0.42, 0.400606060606, 661, 235, 1415
97, 1700, 0.5, 0.403529411765, 686, 235, 1465
97, 1750, 0.36, 0.402285714286, 704, 235, 1515
97, 1800, 0.4, 0.402222222222, 724, 235, 1565
97, 1850, 0.34, 0.400540540541, 741, 235, 1615
97, 1900, 0.44, 0.401578947368, 763, 235, 1665
97, 1950, 0.38, 0.401025641026, 782, 235, 1715
97, 2000, 0.32, 0.399, 798, 236, 1764
98, 50, 0.46, 0.46, 23, 25, 25
98, 100, 0.36, 0.41, 41, 45, 55
98, 150, 0.38, 0.4, 60, 68, 82
98, 200, 0.42, 0.405, 81, 96, 104
98, 250, 0.36, 0.396, 99, 122, 128
98, 300, 0.4, 0.396666666667, 119, 149, 151
98, 350, 0.42, 0.4, 140, 169, 181
98, 400, 0.38, 0.3975, 159, 195, 205
98, 450, 0.44, 0.402222222222, 181, 214, 236
98, 500, 0.46, 0.408, 204, 233, 267
98, 550, 0.32, 0.4, 220, 252, 298
98, 600, 0.44, 0.403333333333, 242, 268, 332
98, 650, 0.52, 0.412307692308, 268, 278, 372
98, 700, 0.52, 0.42, 294, 290, 410
98, 750, 0.34, 0.414666666667, 311, 298, 452
98, 800, 0.42, 0.415, 332, 309, 491
98, 850, 0.3, 0.408235294118, 347, 316, 534
98, 900, 0.26, 0.4, 360, 325, 575
98, 950, 0.44, 0.402105263158, 382, 333, 617
98, 1000, 0.42, 0.403, 403, 342, 658
98, 1050, 0.36, 0.400952380952, 421, 345, 705
98, 1100, 0.38, 0.4, 440, 354, 746
98, 1150, 0.32, 0.39652173913, 456, 359, 791
98, 1200, 0.3, 0.3925, 471, 364, 836
98, 1250, 0.38, 0.392, 490, 369, 881
98, 1300, 0.42, 0.393076923077, 511, 379, 921
98, 1350, 0.42, 0.394074074074, 532, 389, 961
98, 1400, 0.42, 0.395, 553, 396, 1004
98, 1450, 0.4, 0.395172413793, 573, 400, 1050
98, 1500, 0.46, 0.397333333333, 596, 402, 1098
98, 1550, 0.32, 0.394838709677, 612, 405, 1145
98, 1600, 0.38, 0.394375, 631, 411, 1189
98, 1650, 0.38, 0.393939393939, 650, 417, 1233
98, 1700, 0.36, 0.392941176471, 668, 422, 1278
98, 1750, 0.3, 0.390285714286, 683, 427, 1323
98, 1800, 0.44, 0.391666666667, 705, 433, 1367
98, 1850, 0.46, 0.393513513514, 728, 441, 1409
98, 1900, 0.46, 0.395263157895, 751, 448, 1452
98, 1950, 0.34, 0.393846153846, 768, 454, 1496
98, 2000, 0.56, 0.398, 796, 457, 1543
99, 50, 0.4, 0.4, 20, 31, 19
99, 100, 0.42, 0.41, 41, 54, 46
99, 150, 0.38, 0.4, 60, 76, 74
99, 200, 0.54, 0.435, 87, 102, 98
99, 250, 0.38, 0.424, 106, 133, 117
99, 300, 0.52, 0.44, 132, 153, 147
99, 350, 0.5, 0.448571428571, 157, 175, 175
99, 400, 0.42, 0.445, 178, 196, 204
99, 450, 0.48, 0.448888888889, 202, 208, 242
99, 500, 0.42, 0.446, 223, 212, 288
99, 550, 0.24, 0.427272727273, 235, 215, 335
99, 600, 0.44, 0.428333333333, 257, 223, 377
99, 650, 0.3, 0.418461538462, 272, 234, 416
99, 700, 0.34, 0.412857142857, 289, 249, 451
99, 750, 0.5, 0.418666666667, 314, 260, 490
99, 800, 0.32, 0.4125, 330, 267, 533
99, 850, 0.26, 0.403529411765, 343, 278, 572
99, 900, 0.52, 0.41, 369, 280, 620
99, 950, 0.34, 0.406315789474, 386, 285, 665
99, 1000, 0.32, 0.402, 402, 293, 707
99, 1050, 0.44, 0.40380952381, 424, 306, 744
99, 1100, 0.46, 0.406363636364, 447, 329, 771
99, 1150, 0.34, 0.40347826087, 464, 342, 808
99, 1200, 0.34, 0.400833333333, 481, 351, 849
99, 1250, 0.3, 0.3968, 496, 364, 886
99, 1300, 0.24, 0.390769230769, 508, 382, 918
99, 1350, 0.4, 0.391111111111, 528, 411, 939
99, 1400, 0.38, 0.390714285714, 547, 450, 950
99, 1450, 0.32, 0.388275862069, 563, 480, 970
99, 1500, 0.42, 0.389333333333, 584, 507, 993
99, 1550, 0.4, 0.389677419355, 604, 539, 1011
99, 1600, 0.36, 0.38875, 622, 569, 1031
99, 1650, 0.32, 0.386666666667, 638, 599, 1051
99, 1700, 0.48, 0.389411764706, 662, 636, 1064
99, 1750, 0.26, 0.385714285714, 675, 661, 1089
99, 1800, 0.32, 0.383888888889, 691, 688, 1112
99, 1850, 0.28, 0.381081081081, 705, 724, 1126
99, 1900, 0.36, 0.380526315789, 723, 758, 1142
99, 1950, 0.3, 0.378461538462, 738, 788, 1162
99, 2000, 0.38, 0.3785, 757, 804, 1196
